ID;KOD;NAZWA;mlodzi;sredni;starsi;suma
1;1218082;Tomice;1559;5760;920;8239
2;212033;Lwówek Śląski;2733;13273;2138;18144
3;414112;Warlubie;1221;4813;652;6686
4;416022;Gostycyn;957;3800;589;5346
5;601032;Biała Podlaska;2598;9342;1671;13611
6;601182;Wisznice;806;3527;850;5183
7;601142;Sławatycze;415;1621;483;2519
8;601112;Piszczac;1288;5006;1124;7418
9;601132;Rossosz;405;1620;364;2389
10;1003012;Buczek;784;3520;727;5031
11;1417011;Józefów;3453;13000;2582;19035
12;1417032;Celestynów;1888;8189;1308;11385
13;1437022;Kuczbork-Osada;847;3344;775;4966
14;2002013;Choroszcz;2176;10062;1789;14027
15;416063;Tuchola;3196;14180;2326;19702
16;418063;Chodecz;938;4658;882;6478
17;602142;Turobin;838;4161;1497;6496
18;802052;Gubin;1415;6369;911;8695
19;802011;Gubin;2231;11027;1759;15017
20;802032;Bytnica;458;2116;322;2896
21;1004082;Witonia;450;2339;539;3328
22;1418032;Lesznowola;3804;11706;1347;16857
23;1419022;Bodzanów;1333;5982;1245;8560
24;1816042;Chmielnik;1272;4789;990;7051
25;1816132;Trzebownisko;3616;14082;2394;20092
26;2002063;Łapy;3115;16440;3220;22775
27;2002082;Poświętne;604;2394;618;3616
28;418123;Lubraniec;1521;6991;1519;10031
29;2464011;Częstochowa;29337;169401;36892;235630
30;803023;Międzyrzecz;3778;18360;3070;25208
31;804023;Bytom Odrzański;795;3388;487;4670
32;805033;Ośno Lubuskie;1114;4699;694;6507
33;1006103;Rzgów;1573;7151;1264;9988
34;1007052;Paradyż;901;3039;660;4600
35;1007043;Opoczno;5854;25565;4013;35432
36;1007072;Sławno;1425;5059;1083;7567
37;1420122;Załuski;999;3954;775;5728
38;1605013;Gogolin;1651;8957;1898;12506
39;1605053;Zdzieszowice;2296;12325;1900;16521
40;216053;Przemków;1332;6448;1060;8840
41;217012;Borów;767;3737;711;5215
42;2402052;Jasienica;4053;16389;2621;23063
43;2402093;Wilamowice;2599;10914;2045;15558
44;614032;Janowiec;592;2671;507;3770
45;614052;Końskowola;1379;6361;1494;9234
46;614092;Puławy;2101;9345;2021;13467
47;2206052;Liniewo;852;3265;509;4626
48;1019032;Zapolice;779;3549;634;4962
49;1018032;Galewice;1060;4420;839;6319
50;1805092;Skołyszyn;2028;8685;1612;12325
51;1807092;Wojaszówka;1486;6311;1290;9087
52;226011;Wojcieszów;581;2978;496;4055
53;226021;Złotoryja;2211;12280;1854;16345
54;407073;Pakość;1543;7213;1219;9975
55;407082;Rojewo;852;3278;486;4616
56;408022;Bobrowniki;603;2271;316;3190
57;3210022;Boleszkowice;475;2100;319;2894
58;3210052;Nowogródek Pomorski;627;2446;342;3415
59;615072;Ulan-Majorat;1165;4144;912;6221
60;616032;Nowodwór;754;2853;499;4106
61;616052;Stężyca;820;3737;930;5487
62;617011;Świdnik;4473;22915;3760;31148
63;1020011;Głowno;2126;10858;2357;15341
64;1020052;Głowno;698;3305;793;4796
65;1021052;Rogów;720;3474;730;4924
66;1403011;Garwolin;3042;12265;1897;17204
67;1403032;Borowie;961;3598;780;5339
68;1403143;Żelechów;1516;5963;1036;8515
69;1809032;Horyniec-Zdrój;799;3421;762;4982
70;204043;Wąsosz;1293;5282;924;7499
71;3212022;Kozielice;447;1864;314;2625
72;3213032;Darłowo;1397;5846;809;8052
73;618011;Tomaszów Lubelski;2547;13221;2331;18099
74;618072;Rachanie;803;3815;984;5602
75;2212072;Potęgowo;1260;5210;691;7161
76;2212042;Główczyce;1831;6993;896;9720
77;2212062;Kobylnica;1795;7812;954;10561
78;1410012;Huszlew;502;1926;596;3024
79;1410023;Łosice;1708;7942;1492;11142
80;2814013;Barczewo;2885;12471;1684;17040
81;2801043;Bisztynek;1101;4926;840;6867
82;2815032;Grunwald;1152;4074;594;5820
83;2815011;Ostróda;5001;24646;4401;34048
84;2862011;Olsztyn;23050;127043;22312;172405
85;2819022;Pozezdrze;513;2444;445;3402
86;2802042;Lelkowo;458;2214;398;3070
87;2803011;Działdowo;3352;15906;2159;21417
88;2802022;Braniewo;1170;4604;595;6369
89;3001043;Margonin;1233;4675;611;6519
90;3002032;Drawsko;997;3973;628;5598
91;3002062;Połajewo;1184;4397;675;6256
92;3013072;Włoszakowice;1668;6182;892;8742
93;3013043;Rydzyna;1565;6098;789;8452
94;3018012;Czajków;419;1699;349;2467
95;3019032;Kaczory;1348;5659;727;7734
96;3019011;Piła;11160;54648;8870;74678
97;3019093;Wysoka;1260;4995;653;6908
98;3019073;Ujście;1371;5967;902;8240
99;3021062;Kleszczewo;1343;4349;504;6196
100;3024042;Obrzycko;796;3237;489;4522
101;3022033;Miejska Górka;1667;6628;1075;9370
102;3028053;Skoki;1624;6537;884;9045
103;3031033;Krajenka;1321;5439;766;7526
104;3010142;Wilczyn;1181;4420;711;6312
105;2602042;Nagłowice;827;3497;862;5186
106;2602063;Sędziszów;1926;9351;1799;13076
107;2602012;Imielno;706;3064;778;4548
108;2604012;Bieliny;1851;6932;1070;9853
109;2604112;Mniów;1619;6383;1047;9049
110;2605033;Końskie;5120;26424;5384;36928
111;2605083;Stąporków;2376;13066;3087;18529
112;2606053;Ożarów;1753;8062;1491;11306
113;2609082;Wilczyce;554;2581;587;3722
114;2608043;Pińczów;3002;15554;3376;21932
115;2612043;Osiek;1364;5529;1235;8128
116;2607062;Waśniów;1140;4789;1127;7056
117;2608052;Złota;672;3303;848;4823
118;2609011;Sandomierz;3351;18094;3793;25238
119;2609072;Samborzec;1277;5929;1431;8637
120;2806011;Giżycko;3825;19453;3743;27021
121;2804073;Pasłęk;3171;14257;2350;19778
122;2613012;Kluczewsko;915;3527;800;5242
123;2807011;Iława;4653;22657;3875;31185
124;1821022;Cisna;236;1280;211;1727
125;1801052;Lutowiska;357;1600;194;2151
126;1412123;Mrozy;1379;6040;1344;8763
127;1211023;Szczawnica;1183;5164;1039;7386
128;1205092;Sękowa;858;3480;665;5003
129;208143;Szczytna;993;5640;837;7470
130;208092;Lewin Kłodzki;359;1939;369;2667
131;612023;Józefów nad Wisłą;1021;4655;1194;6870
132;2601083;Wiślica;768;3840;1011;5619
133;1404043;Sanniki;984;4506;939;6429
134;1422042;Jednorożec;1438;5033;987;7458
135;2008022;Jasionówka;445;2033;502;2980
136;2477011;Tychy;17504;95591;15912;129007
137;3025032;Nowe Miasto nad Wartą;1611;6482;999;9092
138;2264011;Sopot;3180;21914;6655;31749
139;2211011;Hel;681;3030;404;4115
140;2211062;Krokowa;2154;7189;926;10269
141;1013042;Rawa Mazowiecka;1503;6183;1256;8942
142;1019042;Zduńska Wola;2015;8218;1525;11758
143;1016042;Czerniewice;847;3601;762;5210
144;2006042;Mały Płock;811;3413;775;4999
145;2807032;Iława;2801;10599;1330;14730
146;2801032;Bartoszyce;1992;8518;1301;11811
147;2413072;Świerklaniec;1869;9625;1763;13257
148;2408031;Orzesze;3121;14002;2685;19808
149;1433072;Sadowne;993;4230;1045;6268
150;3207063;Wolin;1936;8990;1287;12213
151;2601043;Pacanów;1160;5267;1522;7949
152;3021163;Swarzędz;7513;31214;3955;42682
153;3210043;Myślibórz;3056;15201;2614;20871
154;1406042;Goszczyn;562;1996;394;2952
155;1406022;Błędów;1272;5296;1223;7791
156;1810032;Czarna;1926;7713;1421;11060
157;1212073;Wolbrom;3441;16352;3546;23339
158;1215021;Sucha Beskidzka;1368;6629;1296;9293
159;205062;Wądroże Wielkie;694;2870;543;4107
160;408092;Wielgie;1270;4668;785;6723
161;408082;Tłuchowo;878;3176;557;4611
162;411011;Radziejów;859;4356;741;5956
163;3214023;Chociwel;940;4416;689;6045
164;3214053;Ińsko;553;2532;478;3563
165;619052;Urszulin;693;2736;635;4064
166;620082;Radecznica;815;4136;1381;6332
167;2213122;Starogard Gdański;3237;11698;1244;16179
168;2213132;Zblewo;2183;7980;1010;11173
169;2214062;Tczew;2525;9225;1118;12868
170;1411102;Szelków;811;2895;628;4334
171;1412011;Mińsk Mazowiecki;5954;24511;4414;34879
172;1412142;Stanisławów;1190;4734;882;6806
173;1412151;Sulejówek;2820;13126;2852;18798
174;1407032;Gniewoszów;617;2880;741;4238
175;1810042;Łańcut;3551;13896;2837;20284
176;1216072;Rzepiennik Strzyżewski;1270;4444;976;6690
177;208072;Kłodzko;2640;13066;2220;17926
178;3217043;Tuczno;821;3629;652;5102
179;662011;Chełm;8605;47749;8443;64797
180;664011;Zamość;8910;47071;7816;63797
181;811032;Brody;617;2553;366;3536
182;2215062;Linia;1353;4063;500;5916
183;1413011;Mława;4697;22244;3669;30610
184;1812012;Harasiuki;999;4421;942;6362
185;1216133;Wojnicz;2307;9268;1675;13250
186;209082;Ruja;460;1838;411;2709
187;413043;Więcbork;2362;9449;1637;13448
188;414032;Drzycim;885;3656;562;5103
189;3218013;Dobra;719;3294;522;4535
190;3218032;Radowo Małe;584;2699;415;3698
191;601021;Terespol;933;4100;714;5747
192;811052;Lipinki Łużyckie;531;2373;389;3293
193;1414063;Zakroczym;1018;4511;757;6286
194;1415032;Czerwin;837;3490;855;5182
195;1813052;Krzywcza;847;3517;632;4996
196;604082;Werbkowice;1504;6908;1565;9977
197;605032;Dzwola;1048;4378;1193;6619
198;606022;Fajsławice;720;3330;830;4880
199;805053;Słubice;2970;14897;2080;19947
200;806052;Zwierzyn;732;3007;483;4222
201;807032;Słońsk;865;3526;516;4907
202;1009052;Rząśnia;824;3228;775;4827
203;1421021;Pruszków;8527;40140;8620;57287
204;1819052;Wiśniowa;1474;5709;1206;8389
205;2005062;Hajnówka;731;3832;1222;5785
206;219043;Jaworzyna Śląska;1479;7402;1241;10122
207;2403062;Dębowiec;943;4005;673;5621
208;607023;Annopol;1466;6248;1423;9137
209;606032;Gorzków;426;2430;844;3700
210;606092;Rudnik;494;2069;748;3311
211;808032;Skąpe;774;3676;691;5141
212;808022;Łagów;770;3832;646;5248
213;809022;Bojadła;551;2465;446;3462
214;809013;Babimost;1010;4506;792;6308
215;1010022;Czarnocin;673;2760;611;4044
216;1010062;Moszczenica;2198;9142;1815;13155
217;1010082;Rozprza;2087;8478;1706;12271
218;1011033;Poddębice;2357;11424;2203;15984
219;1423032;Klwów;583;2252;655;3490
220;1423072;Rusinów;733;2878;710;4321
221;1608013;Dobrodzień;1409;7210;1529;10148
222;1202062;Iwkowa;1271;3948;769;5988
223;2008063;Mońki;2222;11050;2267;15539
224;221011;Boguszów-Gorce;2216;11720;2502;16438
225;2404042;Kamienica Polska;764;4006;856;5626
226;608082;Michów;1016;4140;1178;6334
227;608112;Ostrówek;732;2649;734;4115
228;809033;Czerwieńsk;1638;7262;922;9822
229;1012042;Gomunice;1007;4189;850;6046
230;1012082;Lgota Wielka;749;3082;644;4475
231;1012122;Radomsko;1146;4893;907;6946
232;1425042;Jastrzębia;1258;4557;738;6553
233;1609083;Ozimek;2420;15023;2652;20095
234;1203022;Babice;1481;7063;1459;10003
235;1204042;Mędrzechów;531;2429;578;3538
236;2010082;Perlejewo;477;1956;592;3025
237;222033;Wołów;3270;16893;3020;23183
238;223022;Długołęka;4310;17736;2243;24289
239;3202042;Krzęcin;594;2796;478;3868
240;1014032;Brąszewice;823;3013;624;4460
241;1425122;Wolanów;1756;6068;907;8731
242;1426053;Mordy;975;4168;1042;6185
243;3010103;Sompolno;1804;7396;1248;10448
244;3009043;Dąbie;957;4586;976;6519
245;3007093;Stawiszyn;1208;5261;944;7413
246;3008072;Trzcinica;841;3405;581;4827
247;3009063;Kłodawa;2139;9468;1904;13511
248;3010032;Kazimierz Biskupi;1937;8539;1185;11661
249;3031072;Zakrzewo;895;3479;523;4897
250;3012063;Zduny;1255;5392;809;7456
251;2406013;Kłobuck;3059;14849;2971;20879
252;3012033;Koźmin Wielkopolski;2215;9391;1736;13342
253;2405082;Wielowieś;830;4163;916;5909
254;2411053;Kuźnia Raciborska;1626;8746;1738;12110
255;2411022;Kornowac;757;3337;617;4711
256;2409053;Żarki;1385;6018;1149;8552
257;2416092;Włodowice;764;4055;842;5661
258;2416102;Żarnowiec;797;3296;817;4910
259;1433062;Miedzna;612;2827;723;4162
260;1433032;Korytnica;1071;4457;1086;6614
261;1208062;Racławice;374;1721;467;2562
262;1209042;Pcim;2190;7575;1267;11032
263;407053;Janikowo;2012;9909;1709;13630
264;3208052;Rymań;689;2839;444;3972
265;3209022;Biesiekierz;1009;4350;503;5862
266;1426082;Siedlce;2908;11661;1702;16271
267;1611043;Leśnica;1041;5690;1223;7954
268;1611063;Ujazd;947;4382;879;6208
269;1611073;Zawadzkie;1473;9408;1944;12825
270;1205023;Biecz;2773;11694;2368;16835
271;2009042;Puńsk;652;2971;654;4277
272;2011052;Kuźnica;610;2787;809;4206
273;2011072;Sidra;503;2532;730;3765
274;611021;Stoczek Łukowski;450;1963;339;2752
275;2203043;Debrzno;1369;5624;874;7867
276;1015022;Głuchów;1037;3843;976;5856
277;1427072;Zawidz;1275;4836;1028;7139
278;1429011;Sokołów Podlaski;2859;13523;2248;18630
279;1601022;Skarbimierz;1322;5343;758;7423
280;1802052;Jasienica Rosielna;1505;5223;916;7644
281;1801032;Czarna;433;1725;254;2412
282;1206072;Liszki;2773;12249;1832;16854
283;2011083;Sokółka;3973;19187;3462;26622
284;2012072;Suwałki;1340;5268;916;7524
285;2013042;Klukowo;735;2995;871;4601
286;613032;Milanów;721;2735;657;4113
287;1016052;Inowłódz;554;2669;671;3894
288;1016062;Lubochnia;1517;5516;973;8006
289;1429092;Sterdyń;631;2908;945;4484
290;1428011;Sochaczew;5423;27209;5062;37694
291;1428032;Iłów;1055;4233;890;6178
292;1428072;Sochaczew;1748;6964;1103;9815
293;1428082;Teresin;1924;8301;1492;11717
294;1804042;Jarosław;2226;9123;1526;12875
295;1207011;Limanowa;2580;10471;1760;14811
296;1207112;Słopnice;1701;4369;669;6739
297;403022;Dąbrowa Chełmińska;1427;5591;741;7759
298;403083;Solec Kujawski;2719;11917;2057;16693
299;405022;Ciechocin;789;2786;535;4110
300;405052;Radomin;657;2852;555;4064
301;3207052;Świerzno;771;3198;422;4391
302;3206033;Chojna;2321;10279;1583;14183
303;1002113;Żychlin;1599;9170;2025;12794
304;1002022;Bedlno;775;4048;1066;5889
305;202011;Bielawa;3938;22804;4852;31594
306;417052;Ryńsk;1510;5938;968;8416
307;2417112;Rajcza;1429;6361;1424;9214
308;2415052;Godów;2031;9152;1662;12845
309;2403092;Istebna;2284;7896;1192;11372
310;414102;Świekatowo;615;2343;361;3319
311;416052;Śliwice;1214;4210;657;6081
312;601042;Drelów;926;3592;848;5366
313;601052;Janów Podlaski;919;3775;818;5512
314;601152;Sosnówka;376;1750;565;2691
315;601172;Tuczna;545;2025;753;3323
316;601192;Zalesie;787;2944;712;4443
317;1417062;Osieck;554;2344;515;3413
318;1417021;Otwock;7154;32949;7626;47729
319;1435042;Somianka;946;3724;861;5531
320;1437052;Siemiątkowo;631;2522;547;3700
321;1814082;Tryńcza;1523;5628;1117;8268
322;1261011;Kraków;97130;541964;120175;759269
323;218022;Malczyce;898;4242;690;5830
324;218052;Udanin;817;3943;734;5494
325;213033;Milicz;4029;17495;2902;24426
326;602073;Józefów;1052;4794;1096;6942
327;602123;Tarnogród;1146;4982;970;7098
328;602132;Tereszpol;670;2764;594;4028
329;1006032;Brójce;1033;4406;676;6115
330;1419102;Radzanowo;1366;5636;916;7918
331;1462011;Płock;17577;90175;16228;123980
332;1816102;Lubenia;1035;4385;1028;6448
333;1817022;Besko;824;3123;474;4421
334;2002112;Turośń Kościelna;1006;3864;794;5664
335;2207011;Kwidzyn;6080;27360;3793;37233
336;418102;Lubanie;754;3332;596;4682
337;418092;Kowal;610;2823;578;4011
338;418113;Lubień Kujawski;1167;5322;1075;7564
339;419052;Rogowo;1193;4868;825;6886
340;2469011;Katowice;35705;216437;51679;303821
341;603092;Ruda-Huta;772;3282;642;4696
342;603042;Dorohusk;1017;4661;992;6670
343;603122;Wierzbica;949;3835;702;5486
344;804063;Nowe Miasteczko;887;3984;667;5538
345;1007023;Drzewica;1788;7508;1680;10976
346;1419082;Mała Wieś;949;4400;993;6342
347;1419072;Łąck;827;3792;636;5255
348;1419153;Wyszogród;835;4056;925;5816
349;1603011;Kędzierzyn-Koźle;8415;46196;9725;64336
350;1603032;Cisek;768;4059;1014;5841
351;1817052;Sanok;3514;14339;2487;20340
352;1818062;Zaleszany;1751;7549;1507;10807
353;217053;Wiązów;1237;5401;983;7621
354;461011;Bydgoszcz;45809;251056;54886;351751
355;404042;Lisewo;924;3867;611;5402
356;404072;Unisław;1190;4934;804;6928
357;2401011;Będzin;7688;43104;8850;59642
358;614112;Żyrzyn;1071;4613;1041;6725
359;614083;Nałęczów;1349;6371;1422;9142
360;2206022;Dziemiany;822;3007;404;4233
361;2206042;Kościerzyna;3207;10497;1264;14968
362;2206082;Stara Kiszewa;1313;4686;695;6694
363;2209032;Lichnowy;953;3377;448;4778
364;1805112;Tarnowiec;1513;6401;1325;9239
365;1807012;Chorkówka;2514;9701;1880;14095
366;1209092;Wiśniowa;1384;4874;814;7072
367;1210011;Grybów;1064;4130;833;6027
368;1210082;Łabowa;1331;3907;479;5717
369;1210042;Grybów;5274;15965;2604;23843
370;202062;Łagiewniki;1171;5524;939;7634
371;408011;Lipno;2415;10626;1784;14825
372;617033;Piaski;1615;7400;1729;10744
373;617022;Mełgiew;2580;12337;3206;18123
374;2210042;Stegna;1636;7018;1066;9720
375;2212011;Ustka;2291;12338;2231;16860
376;1402072;Opinogóra Górna;990;4136;798;5924
377;1402092;Sońsk;1256;5532;1161;7949
378;1403103;Pilawa;1803;6938;1145;9886
379;1809023;Cieszanów;1301;5457;1017;7775
380;1809042;Lubaczów;1553;6356;1255;9164
381;1809082;Wielkie Oczy;661;2725;620;4006
382;1210142;Podegrodzie;2716;8296;1277;12289
383;1210163;Stary Sącz;4501;16263;2488;23252
384;203042;Kotla;795;3052;470;4317
385;3213042;Malechowo;1155;4808;741;6704
386;618132;Ulhówek;709;3592;766;5067
387;2809053;Orneta;1963;9012;1667;12642
388;2814093;Olsztynek;2322;10023;1541;13886
389;2809022;Kiwity;492;2340;396;3228
390;2810042;Piecki;1415;5741;821;7977
391;2812042;Kurzętnik;1741;6277;966;8984
392;2816043;Ruciane-Nida;1135;6133;1091;8359
393;2816013;Biała Piska;2019;7966;1303;11288
394;2816033;Pisz;4752;20069;3390;28211
395;2815063;Miłakowo;1004;4169;658;5831
396;2802033;Frombork;543;2772;435;3750
397;2801021;Górowo Iławeckie;501;2695;555;3751
398;2802011;Braniewo;2802;13090;1918;17810
399;3013012;Krzemieniewo;1424;5993;890;8307
400;3001032;Chodzież;1212;5256;605;7073
401;3016023;Rogoźno;3294;13017;1848;18159
402;3014043;Sieraków;1529;6298;992;8819
403;3014012;Chrzypsko Wielkie;614;2300;422;3336
404;3017011;Ostrów Wielkopolski;9815;52367;9964;72146
405;3019022;Białośliwie;953;3514;505;4972
406;3019043;Łobżenica;1752;7041;1098;9891
407;3021103;Mosina;4892;20511;3092;28495
408;3028042;Mieścisko;1153;4234;630;6017
409;3028011;Wągrowiec;4050;18179;3002;25231
410;3027073;Tuliszków;1857;7649;1181;10687
411;3031023;Jastrowie;2136;8780;1201;12117
412;3030012;Kołaczkowo;1097;4389;571;6057
413;3005032;Kamieniec;1170;4663;684;6517
414;3010073;Rychwał;1465;5925;1005;8395
415;2601013;Busko-Zdrój;4639;23343;5090;33072
416;2604043;Chmielnik;1848;8128;1711;11687
417;2604062;Górno;2597;10067;1271;13935
418;2606022;Iwaniska;1103;4583;984;6670
419;2605012;Fałków;663;3236;797;4696
420;2610011;Skarżysko-Kamienna;5754;35084;7989;48827
421;2608032;Michałów;752;3162;898;4812
422;2607032;Bodzechów;2113;10214;2283;14610
423;2612062;Rytwiany;1279;5842;991;8112
424;2613022;Krasocin;1807;7407;1484;10698
425;2661011;Kielce;25885;145352;30218;201455
426;2804063;Młynary;879;3283;568;4730
427;2805042;Prostki;1372;5067;793;7232
428;2808032;Kętrzyn;1558;6958;1012;9528
429;2808053;Reszel;1146;5964;1165;8275
430;1807023;Dukla;2480;10232;2062;14774
431;1602043;Kietrz;1661;8300;1643;11604
432;1217011;Zakopane;3861;19537;4613;28011
433;1211052;Jabłonka;3832;11974;1900;17706
434;1210133;Piwniczna-Zdrój;1995;7407;1271;10673
435;1210073;Krynica-Zdrój;2722;11933;2368;17023
436;607083;Urzędów;1407;5792;1377;8576
437;225072;Zgorzelec;1208;5848;747;7803
438;225021;Zgorzelec;3371;20647;4849;28867
439;224073;Złoty Stok;624;3537;628;4789
440;210021;Świeradów-Zdrój;584;2999;539;4122
441;208112;Nowa Ruda;1679;8860;1740;12279
442;206082;Podgórzyn;1107;6049;1067;8223
443;862011;Zielona Góra;18898;100532;18229;137659
444;3204073;Stepnica;792;3511;530;4833
445;1015082;Skierniewice;1329;5760;1244;8333
446;1415083;Myszyniec;2061;7286;1324;10671
447;2473011;Rybnik;20567;100168;17994;138729
448;1013011;Rawa Mazowiecka;2537;13115;1926;17578
449;1815043;Sędziszów Małopolski;4188;16349;3106;23643
450;1816143;Tyczyn;1726;6767;1297;9790
451;2413041;Tarnowskie Góry;7887;42208;8850;58945
452;1214023;Koszyce;847;4001;987;5835
453;1437033;Lubowidz;1193;4788;1116;7097
454;219032;Dobromierz;810;3978;657;5445
455;1061011;Łódź;83818;518852;126182;728852
456;1013032;Cielądz;623;2761;635;4019
457;1416022;Andrzejewo;698;2985;802;4485
458;2807052;Lubawa;2332;7859;1196;11387
459;3021172;Tarnowo Podgórne;4110;15525;2097;21732
460;2208032;Cewice;1517;5227;549;7293
461;1402052;Grudusk;669;2737;578;3984
462;1018062;Sokolniki;791;3504;695;4990
463;1018043;Lututów;762;3178;642;4582
464;1416112;Zaręby Kościelne;623;2436;674;3733
465;1416011;Ostrów Mazowiecka;3756;16929;2696;23381
466;3207013;Dziwnów;493;3033;449;3975
467;3205083;Trzebiatów;2610;12313;1829;16752
468;1438032;Puszcza Mariańska;1360;6331;1280;8971
469;2601063;Stopnica;1157;5460;1310;7927
470;224033;Kamieniec Ząbkowicki;1182;6321;959;8462
471;602063;Goraj;644;2997;859;4500
472;1438053;Wiskitki;1773;7587;1454;10814
473;3001023;Budzyń;1532;6065;759;8356
474;1813023;Dubiecko;1638;6341;1470;9449
475;1810052;Markowa;1200;4857;1083;7140
476;1211102;Ochotnica Dolna;1761;5514;962;8237
477;1212011;Bukowno;1302;7572;1780;10654
478;1213082;Przeciszów;1153;4997;1003;7153
479;1214012;Koniusza;1425;5883;1180;8488
480;1214033;Nowe Brzesko;897;4104;826;5827
481;205023;Bolków;1677;7945;1553;11175
482;3214062;Kobylanka;898;4082;510;5490
483;3214092;Stara Dąbrowa;651;2642;380;3673
484;661011;Biała Podlaska;8751;43206;5968;57925
485;619011;Włodawa;1930;10386;1470;13786
486;619082;Wyryki;441;1903;434;2778
487;2214043;Pelplin;3066;12322;1674;17062
488;1407072;Sieciechów;674;2876;641;4191
489;1810062;Rakszawa;1394;5231;1013;7638
490;1811011;Mielec;8683;45156;8140;61979
491;1811042;Gawłuszowice;463;1865;400;2728
492;1811083;Radomyśl Wielki;2658;9608;1745;14011
493;1213033;Chełmek;1868;9449;1837;13154
494;1215072;Stryszawa;1967;8278;1659;11904
495;1216022;Gromnik;1585;6058;1065;8708
496;208021;Kłodzko;3704;19998;4369;28071
497;410023;Mrocza;1729;6648;899;9276
498;412022;Brzuze;871;3658;731;5260
499;3215052;Grzmiąca;881;3591;574;5046
500;620133;Szczebrzeszyn;1704;7910;1787;11401
501;811011;Łęknica;488;1994;207;2689
502;1408011;Legionowo;7752;34168;6100;48020
503;1409052;Sienno;886;4195;1103;6184
504;1812032;Jeżowe;2002;7056;1181;10239
505;1812022;Jarocin;839;3736;695;5270
506;3218053;Węgorzyno;1235;5113;994;7342
507;601102;Międzyrzec Podlaski;2138;7385;1462;10985
508;1001062;Rusiec;804;3538;858;5200
509;1002011;Kutno;5593;33514;6622;45729
510;1002043;Krośniewice;1285;6351;1390;9026
511;1002032;Dąbrowice;279;1299;347;1925
512;1415092;Olszewo-Borki;1963;7550;1033;10546
513;1415112;Troszyn;808;3306;729;4843
514;1409033;Lipsko;1493;8420;1599;11512
515;1434062;Jadów;1209;5230;1132;7571
516;1813082;Przemyśl;1497;6551;1077;9125
517;1813072;Orły;1549;6018;948;8515
518;1813092;Stubno;742;2784;529;4055
519;1218033;Kalwaria Zebrzydowska;3138;13418;2422;18978
520;1218013;Andrychów;6931;28963;5494;41388
521;1218052;Mucharz;666;2689;510;3865
522;1218042;Lanckorona;1126;4374;717;6217
523;604042;Hrubieszów;1795;7335;1660;10790
524;604062;Trzeszczany;662;3238;779;4679
525;605042;Godziszów;1044;4020;1093;6157
526;605022;Chrzanów;494;1980;636;3110
527;606062;Kraśniczyn;480;2635;920;4035
528;606011;Krasnystaw;2759;14464;2673;19896
529;806032;Stare Kurowo;750;3044;493;4287
530;1008021;Pabianice;8668;49473;11687;69828
531;1009072;Strzelce Wielkie;709;3294;780;4783
532;1009062;Siemkowice;830;3219;708;4757
533;1421033;Brwinów;3852;17442;3501;24795
534;1821033;Lesko;1819;8353;1507;11679
535;2005042;Czyże;229;1334;847;2410
536;220023;Prusice;1588;6984;946;9518
537;2403042;Brenna;1939;7574;1405;10918
538;607052;Kraśnik;1339;5723;1118;8180
539;807053;Torzym;1205;4970;768;6943
540;1423052;Potworów;827;2861;640;4328
541;1424022;Obryte;774;3215;752;4741
542;1608043;Praszka;1804;9979;1526;13309
543;1608052;Radłów;696;3171;671;4538
544;1202012;Borzęcin;1465;6080;1189;8734
545;1202052;Gnojnik;1506;5020;878;7404
546;220052;Zawonia;950;4138;548;5636
547;220042;Wisznia Mała;1576;7017;793;9386
548;265011;Wałbrzych;14453;85207;18794;118454
549;2404122;Olsztyn;1293;5779;1012;8084
550;2404162;Starcza;368;1598;346;2312
551;810053;Małomice;764;3998;740;5502
552;1011062;Zadzim;747;3572;996;5315
553;1424052;Świercze;814;3229;585;4628
554;1424062;Winnica;745;2840;559;4144
555;1425092;Przytyk;1422;4910;912;7244
556;1425062;Jedlnia-Letnisko;2199;8948;1370;12517
557;1609132;Turawa;1344;7238;1496;10078
558;1610013;Biała;1538;7779;1794;11111
559;2010052;Mielnik;290;1572;655;2517
560;223032;Jordanów Śląski;476;2264;360;3100
561;224013;Bardo;721;4086;764;5571
562;3202033;Drawno;782;3879;634;5295
563;609062;Jabłonna;1312;5459;1228;7999
564;609122;Strzyżewice;1310;5586;1074;7970
565;609102;Niedrzwica Duża;2093;7743;1478;11314
566;2201042;Kołczygłowy;798;3062;393;4253
567;1013052;Regnów;303;1232;324;1859
568;1014023;Błaszki;2395;10389;2124;14908
569;1014042;Brzeźnio;1056;4334;936;6326
570;1425103;Skaryszew;2668;9620;1435;13723
571;1426022;Korczew;411;1907;612;2930
572;3010123;Ślesin;2230;9486;1578;13294
573;3063011;Leszno;9780;46577;7946;64303
574;3003053;Kłecko;1335;5609;718;7662
575;3009082;Kościelec;1220;5064;889;7173
576;3009113;Przedecz;717;2980;630;4327
577;3009011;Koło;2964;14769;2571;20304
578;3009092;Olszówka;722;3191;686;4599
579;3003103;Witkowo;2315;10012;1493;13820
580;3004073;Poniec;1303;5681;970;7954
581;2406023;Krzepice;1332;6553;1455;9340
582;3012011;Sulmierzyce;548;2037;280;2865
583;3011043;Krzywiń;1762;7226;1153;10141
584;2406072;Popów;896;4194;880;5970
585;2405042;Pilchowice;1646;7822;1572;11040
586;2407022;Boronów;507;2441;471;3419
587;2407042;Herby;1066;4975;861;6902
588;2412013;Czerwionka-Leszczyny;6647;31079;5785;43511
589;2414021;Imielin;1355;5942;1156;8453
590;2414031;Lędziny;2489;12048;1883;16420
591;2416021;Zawiercie;6599;37312;7712;51623
592;1804102;Roźwienica;1080;4334;820;6234
593;1208022;Gołcza;876;4235;1040;6151
594;407042;Inowrocław;2126;10531;1776;14433
595;2009052;Sejny;746;3373;827;4946
596;2011032;Korycin;586;2339;547;3472
597;201011;Bolesławiec;5035;27884;5859;38778
598;201052;Osiecznica;1514;5423;666;7603
599;401031;Nieszawa;288;1443;264;1995
600;3204043;Nowogard;3945;18284;2680;24909
601;3203013;Czaplinek;1985;8701;1306;11992
602;610042;Milejów;1546;6786;1403;9735
603;610062;Spiczyn;896;3718;715;5329
604;611102;Wojcieszków;1317;4777;1114;7208
605;1014093;Warta;1952;8902;2141;12995
606;1015032;Godzianów;453;1784;383;2620
607;1015092;Słupia;456;1794;426;2676
608;1429072;Sabnie;550;2636;716;3902
609;1206082;Michałowice;1609;6189;958;8756
610;2012062;Rutka-Tartak;459;1642;365;2466
611;2013023;Ciechanowiec;1317;6452;1493;9262
612;401021;Ciechocinek;1376;7581;2176;11133
613;401092;Zakrzewo;545;2511;532;3588
614;402022;Bobrowo;1101;4383;764;6248
615;402053;Górzno;653;2808;508;3969
616;3205043;Płoty;1661;6627;970;9258
617;613012;Dębowa Kłoda;670;2803;646;4119
618;2204011;Pruszcz Gdański;4032;16739;2547;23318
619;1016032;Budziszewice;325;1298;272;1895
620;1016072;Rokiciny;913;4164;1080;6157
621;1016092;Tomaszów Mazowiecki;2021;8540;1547;12108
622;1430032;Mirów;791;2720;532;4043
623;1432013;Błonie;3032;14073;3035;20140
624;1803042;Dębica;4587;17617;2976;25180
625;1804073;Pruchnik;1845;6749;1240;9834
626;1804082;Radymno;2094;7818;1502;11414
627;1207052;Kamienica;1670;5063;806;7539
628;3206043;Gryfino;4917;23924;3161;32002
629;3015063;Zbąszyń;2360;9684;1510;13554
630;1604032;Lasowice Wielkie;874;5069;1088;7031
631;203062;Żukowice;612;2635;375;3622
632;207022;Kamienna Góra;1492;6504;948;8944
633;3209053;Mielno;623;3331;581;4535
634;2604123;Morawica;2693;10669;1373;14735
635;2411072;Pietrowice Wielkie;932;4951;1041;6924
636;2403072;Goleszów;1917;8837;1848;12602
637;1219012;Biskupice;1789;6925;1135;9849
638;212023;Lubomierz;976;4585;723;6284
639;415062;Łysomice;1695;6680;924;9299
640;601122;Rokitno;545;2065;618;3228
641;1002062;Kutno;1353;6690;1271;9314
642;1417082;Wiązowna;1998;7825;1223;11046
643;1437013;Bieżuń;851;3660;829;5340
644;1816092;Krasne;1891;7466;1354;10711
645;213012;Cieszków;814;3334;523;4671
646;213022;Krośnice;1471;6019;911;8401
647;2461011;Bielsko-Biała;23989;123749;26361;174099
648;602011;Biłgoraj;4324;19974;2977;27275
649;602053;Frampol;921;4110;1117;6148
650;602082;Księżpol;1214;4745;860;6819
651;603011;Rejowiec Fabryczny;689;3275;559;4523
652;801042;Kłodawa;1388;5645;565;7598
653;1004072;Świnice Warckie;607;2897;631;4135
654;1005042;Domaniewice;727;3215;719;4661
655;1005082;Łyszkowice;1209;5072;1125;7406
656;1006082;Nowosolna;722;2947;448;4117
657;1418052;Prażmów;1828;6983;1058;9869
658;1419032;Brudzeń Duży;1455;5756;1010;8221
659;1438023;Mszczonów;1894;8074;1509;11477
660;1816052;Dynów;1305;5037;1180;7522
661;2002052;Juchnowiec Kościelny;2313;10036;1704;14053
662;2207062;Sadlinki;1155;4286;449;5890
663;419013;Barcin;2366;10941;1674;14981
664;2402032;Buczkowice;1583;6956;1384;9923
665;803053;Skwierzyna;1867;9466;1334;12667
666;804082;Siedlisko;847;3166;434;4447
667;1419122;Słupno;1242;5520;745;7507
668;1420062;Joniec;443;1764;442;2649
669;1420092;Płońsk;1323;5363;911;7597
670;1603042;Pawłowiczki;1109;5843;1296;8248
671;1605032;Strzeleczki;997;5326;1239;7562
672;1605042;Walce;747;4120;940;5807
673;1817011;Sanok;5256;26554;4590;36400
674;1818022;Bojanów;1328;5189;856;7373
675;1819022;Frysztak;1869;7272;1421;10562
676;1819012;Czudec;1908;7963;1672;11543
677;1819032;Niebylec;1753;7180;1520;10453
678;2003011;Bielsk Podlaski;3611;19661;3486;26758
679;2003072;Rudka;325;1340;377;2042
680;404011;Chełmno;3139;15107;2586;20832
681;614072;Markuszów;481;2047;476;3004
682;614102;Wąwolnica;781;3330;743;4854
683;2205072;Sulęczyno;1107;3433;541;5081
684;2205083;Żukowo;6583;20992;2446;30021
685;1017082;Skomlin;584;2383;471;3438
686;1018052;Łubnice;706;2811;599;4116
687;1807043;Jedlicze;2465;11026;2120;15611
688;1209052;Raciechowice;1054;4280;810;6144
689;1210052;Kamionka Wielka;2229;6717;1030;9976
690;1210102;Łososina Dolna;2332;7098;1199;10629
691;226032;Pielgrzymka;764;3352;479;4595
692;226043;Świerzawa;1150;5699;855;7704
693;226062;Złotoryja;1165;5498;783;7446
694;408052;Kikół;1331;5156;842;7329
695;3211012;Dobra (Szczecińska);3288;11827;959;16074
696;615082;Wohyń;1170;4774;1155;7099
697;616043;Ryki;3235;14412;2750;20397
698;2209082;Stare Pole;834;3313;473;4620
699;1808042;Leżajsk;3631;14181;2588;20400
700;1808032;Kuryłówka;948;4007;774;5729
701;1808053;Nowa Sarzyna;3844;15109;2603;21556
702;1809063;Oleszyce;1058;4551;800;6409
703;204032;Niechlów;909;3630;646;5185
704;3213021;Sławno;1967;9469;1768;13204
705;618022;Bełżec;573;2428;443;3444
706;1410042;Platerów;822;3516;920;5258
707;1411052;Młynarze;287;1194;249;1730
708;2812022;Biskupiec;1836;6663;1136;9635
709;2814042;Dywity;1768;7105;714;9587
710;2819033;Węgorzewo;2471;12623;2340;17434
711;2802053;Pieniężno;971;4949;812;6732
712;2802062;Płoskinia;482;1811;286;2579
713;2803043;Lidzbark;2468;10301;1802;14571
714;3013033;Osieczna;1501;6305;1043;8849
715;3013062;Wijewo;784;2572;323;3679
716;3001053;Szamocin;1441;5327;794;7562
717;3002043;Krzyż Wielkopolski;1534;6627;1088;9249
718;3017033;Odolanów;2524;10369;1521;14414
719;3015032;Miedzichowo;628;2628;368;3624
720;3018022;Doruchów;984;3695;544;5223
721;3017082;Sośnie;1128;4567;638;6333
722;3020063;Pleszew;4782;21952;3730;30464
723;3025052;Zaniemyśl;1092;4765;719;6576
724;3026023;Dolsk;1093;4388;669;6150
725;3025012;Dominowo;515;2018;276;2809
726;3028022;Damasławek;1035;4017;658;5710
727;3028062;Wapno;528;2227;368;3123
728;3030053;Września;7450;32583;5286;45319
729;3029022;Siedlec;2324;8756;1205;12285
730;3029012;Przemęt;2528;9854;1422;13804
731;3010082;Rzgów;1250;4918;822;6990
732;2602033;Małogoszcz;2071;8427;1433;11931
733;2601072;Tuczępy;631;2627;619;3877
734;2601052;Solec-Zdrój;765;3437;853;5055
735;2606043;Opatów;1706;8869;2007;12582
736;2604102;Miedziana Góra;1860;8181;1117;11158
737;2604092;Masłów;1833;7992;1102;10927
738;2611032;Mirzec;1387;6119;1382;8888
739;2610042;Skarżysko Kościelne;897;4308;967;6172
740;2610053;Suchedniów;1357;7722;1729;10808
741;2608013;Działoszyce;707;3563;1138;5408
742;2806052;Kruklanki;552;2250;366;3168
743;2804082;Rychliki;726;2871;504;4101
744;2804052;Milejewo;569;2404;286;3259
745;2805011;Ełk;9115;41646;5993;56754
746;2403031;Wisła;1648;7995;1729;11372
747;2002073;Michałowo;852;4692;1640;7184
748;1217042;Kościelisko;1462;5990;1018;8470
749;1211062;Krościenko nad Dunajcem;1199;4590;881;6670
750;208103;Międzylesie;1092;5516;877;7485
751;208083;Lądek-Zdrój;1130;6457;1275;8862
752;208063;Bystrzyca Kłodzka;2591;14620;2651;19862
753;208011;Duszniki-Zdrój;618;3643;801;5062
754;206041;Szklarska Poręba;821;5193;1068;7082
755;206011;Karpacz;557;3660;654;4871
756;804073;Otyń;1261;5081;649;6991
757;2604073;Łagów;1224;4897;1028;7149
758;618053;Lubycza Królewska;1085;4763;845;6693
759;620142;Zamość;3934;16752;2832;23518
760;2008043;Knyszyn;773;3526;754;5053
761;2801011;Bartoszyce;3500;17766;2939;24205
762;2612083;Szydłów;635;3253;738;4626
763;1008072;Pabianice;1003;4599;839;6441
764;1609032;Dobrzeń Wielki;1179;6695;1254;9128
765;2213013;Czarna Woda;522;2233;436;3191
766;2601033;Nowy Korczyn;879;4321;1208;6408
767;3062011;Konin;10557;56337;10641;77535
768;2817083;Wielbark;1242;4604;682;6528
769;3064011;Poznań;71375;402603;84012;557990
770;2402102;Wilkowice;1852;8892;1832;12576
771;1411092;Sypniewo;568;2423;498;3489
772;1404022;Gostynin;1998;8360;1595;11953
773;1405011;Milanówek;2205;10589;2390;15184
774;1405021;Podkowa Leśna;637;2865;759;4261
775;1810011;Łańcut;2765;12890;2708;18363
776;1212053;Olkusz;6952;36438;6240;49630
777;408043;Dobrzyń nad Wisłą;1314;5625;955;7894
778;408062;Lipno;2240;8352;1325;11917
779;409033;Mogilno;3900;17917;2927;24744
780;3215062;Szczecinek;1765;7015;896;9676
781;620102;Skierbieszów;865;3569;1130;5564
782;2213052;Kaliska;958;3690;545;5193
783;2214052;Subkowy;1063;3826;479;5368
784;1412102;Latowicz;981;3670;856;5507
785;1406053;Grójec;4050;17714;3075;24839
786;1810072;Żołynia;1232;4623;926;6781
787;410053;Szubin;4094;17280;2387;23761
788;412062;Wąpielsk;725;2898;582;4205
789;3216033;Połczyn-Zdrój;2273;11625;2079;15977
790;620112;Stary Zamość;820;3632;924;5376
791;620153;Zwierzyniec;1094;5198;1271;7563
792;811021;Żary;5767;28363;4928;39058
793;1413102;Wiśniewo;928;3724;730;5382
794;1413062;Stupsk;870;3541;692;5103
795;1414043;Nasielsk;3230;14045;2407;19682
796;1408043;Serock;2164;8909;1392;12465
797;1217022;Biały Dunajec;1304;5129;863;7296
798;209022;Chojnów;1454;6678;1203;9335
799;210011;Lubań;2812;15881;3008;21701
800;413013;Kamień Krajeński;1317;4984;749;7050
801;414082;Pruszcz;1647;6857;1103;9607
802;811102;Żary;2079;9086;1211;12376
803;812013;Sława;2264;8984;1290;12538
804;1001052;Kluki;703;2819;604;4126
805;1002082;Nowe Ostrowy;563;2659;539;3761
806;1415062;Lelis;1849;6434;927;9210
807;1416032;Boguty-Pianki;472;1847;493;2812
808;1218093;Wadowice;6171;26514;5058;37743
809;604022;Dołhobyczów;863;4184;954;6001
810;807012;Krzeszyce;758;3327;562;4647
811;1008042;Dobroń;1179;5699;989;7867
812;1008032;Dłutów;675;3154;697;4526
813;1421062;Raszyn;3335;13752;2637;19724
814;1422023;Chorzele;1906;7040;1410;10356
815;1607042;Łambinowice;1149;5621;988;7758
816;1607033;Korfantów;1339;6647;1190;9176
817;1607053;Nysa;7623;42816;8342;58781
818;1607092;Skoroszyce;1060;4725;731;6516
819;219011;Świdnica;7699;43108;8763;59570
820;219052;Marcinowice;1020;4721;659;6400
821;220013;Oborniki Śląskie;2928;13818;2333;19079
822;2403103;Skoczów;4201;18850;3333;26384
823;607011;Kraśnik;4826;25208;5509;35543
824;607062;Szastarka;961;3983;1043;5987
825;606112;Żółkiewka;776;3751;1368;5895
826;1423063;Przysucha;1651;8920;1742;12313
827;1423022;Gielniów;672;3106;823;4601
828;1424012;Gzy;650;2775;620;4045
829;1608033;Olesno;2350;12779;2787;17916
830;1609062;Murów;682;4043;832;5557
831;1202023;Brzesko;5924;25450;4259;35633
832;1201022;Bochnia;3278;13267;2309;18854
833;2007062;Przytuły;365;1498;312;2175
834;2007013;Jedwabne;911;3907;865;5683
835;221021;Jedlina-Zdrój;613;3301;748;4662
836;2404013;Blachownia;1912;9819;2174;13905
837;2404032;Janów;903;4399;852;6154
838;2404092;Lelów;668;3415;919;5002
839;2404112;Mykanów;2347;10330;1740;14417
840;607102;Zakrzówek;969;4436;1209;6614
841;608092;Niedźwiada;1101;4300;919;6320
842;809043;Kargowa;963;4157;639;5759
843;1011012;Dalików;593;2587;583;3763
844;1425072;Kowala;2152;7328;1076;10556
845;1204012;Bolesław;397;2053;515;2965
846;2008032;Jaświły;824;3573;998;5395
847;223052;Kobierzyce;3058;11765;1456;16279
848;3202063;Recz;945;4269;624;5838
849;2201082;Studzienice;669;2588;357;3614
850;1012113;Przedbórz;1141;5272;1193;7606
851;1425132;Zakrzew;2368;8083;1114;11565
852;3007032;Ceków-Kolonia;806;3474;614;4894
853;3007042;Godziesze Wielkie;1478;6195;1087;8760
854;3007062;Lisków;875;3633;803;5311
855;3003032;Gniezno;2036;7584;893;10513
856;3009052;Grzegorzew;998;3976;765;5739
857;3003082;Niechanowo;1238;4400;576;6214
858;3005023;Grodzisk Wielkopolski;3335;13899;1992;19226
859;2406042;Miedźno;1138;5254;1101;7493
860;2406082;Przystajń;914;4127;855;5896
861;2407052;Kochanowice;1028;4771;814;6613
862;2405021;Pyskowice;2402;13578;2860;18840
863;2406062;Panki;875;3779;805;5459
864;2410012;Goczałkowice-Zdrój;1053;4541;889;6483
865;2415031;Rydułtowy;2994;14802;2997;20793
866;2415092;Mszana;1580;7307;1168;10055
867;2417102;Radziechowy-Wieprz;2381;9669;1746;13796
868;2417122;Ślemień;574;2467;457;3498
869;2416083;Szczekociny;1118;5689;1345;8152
870;1432032;Kampinos;678;2740;518;3936
871;1806012;Cmolas;1439;5446;1086;7971
872;1209013;Dobczyce;2627;10326;1442;14395
873;406012;Grudziądz;2184;8339;1145;11668
874;406062;Świecie nad Osą;887;3039;426;4352
875;407033;Gniewkowo;2506;10821;1801;15128
876;3209042;Manowo;1161;5076;613;6850
877;1611022;Jemielnica;921;5099;1020;7040
878;1601033;Grodków;3162;14239;2333;19734
879;1601043;Lewin Brzeski;2201;9646;1608;13455
880;1205033;Bobowa;2143;6593;1089;9825
881;1206032;Iwanowice;1519;6026;1114;8659
882;2011043;Krynki;415;2295;642;3352
883;2011093;Suchowola;1144;4850;1308;7302
884;201022;Bolesławiec;2516;11144;1374;15034
885;201062;Warta Bolesławiecka;1396;6125;864;8385
886;201043;Nowogrodziec;2633;11016;1665;15314
887;401072;Raciążek;466;2325;383;3174
888;610012;Cyców;1492;5470;946;7908
889;611062;Serokomla;701;2672;725;4098
890;611052;Łuków;3513;11998;1954;17465
891;1014072;Klonowa;516;2061;514;3091
892;1014102;Wróblew;954;4163;952;6069
893;1427022;Gozdowo;1064;4243;831;6138
894;1429022;Bielany;674;2666;677;4017
895;1429082;Sokołów Podlaski;1001;4263;896;6160
896;1802062;Nozdrzec;1395;5766;1425;8586
897;1803052;Jodłowa;947;3857;828;5632
898;1803011;Dębica;6855;34459;5695;47009
899;1206022;Igołomia-Wawrzeńczyce;1260;5423;1001;7684
900;1206042;Jerzmanowice-Przeginia;1758;7137;1453;10348
901;611112;Wola Mysłowska;829;3410;888;5127
902;2208042;Nowa Wieś Lęborska;2610;9746;1137;13493
903;1016022;Będków;460;2327;545;3332
904;1016082;Rzeczyca;775;3329;813;4917
905;1017032;Konopnica;578;2650;664;3892
906;1430042;Orońsko;1067;4096;732;5895
907;1803063;Pilzno;3287;12266;2341;17894
908;1804052;Laszki;1208;4727;961;6896
909;1207042;Jodłownik;1584;5363;1011;7958
910;1207082;Łukowica;2100;6235;1107;9442
911;2013072;Nowe Piekuty;722;2707;734;4163
912;2014032;Rutki;1029;4035;860;5924
913;403043;Koronowo;3984;17508;2607;24099
914;3206023;Cedynia;760;3218;486;4464
915;2807063;Susz;2480;9326;1277;13083
916;3015023;Lwówek;1769;6499;1037;9305
917;1211132;Spytkowice;908;2936;490;4334
918;3002022;Czarnków;2189;9257;1251;12697
919;2411033;Krzanowice;753;4275;894;5922
920;2403082;Hażlach;1913;7618;1081;10612
921;1263011;Tarnów;15267;80903;17315;113485
922;415011;Chełmża;2487;11003;1858;15348
923;416012;Cekcyn;1259;5138;759;7156
924;416042;Lubiewo;1156;4111;667;5934
925;1004022;Daszyna;626;2839;733;4198
926;1417052;Kołbiel;1297;5633;1121;8051
927;1417072;Sobienie-Jeziory;920;4361;1056;6337
928;1814062;Przeworsk;2602;10241;2109;14952
929;1815022;Ostrów;1174;4744;870;6788
930;1219053;Wieliczka;8923;37432;6503;52858
931;2001032;Bargłów Kościelny;1037;3893;879;5809
932;218012;Kostomłoty;1105;5066;790;6961
933;218032;Miękinia;2254;9731;1327;13312
934;218043;Środa Śląska;2975;14217;2311;19503
935;214023;Bierutów;1552;7556;1139;10247
936;214042;Dziadowa Kłoda;823;3332;454;4609
937;214053;Międzybórz;950;3707;513;5170
938;418032;Boniewo;600;2433;519;3552
939;602042;Biszcza;609;2667;541;3817
940;602102;Obsza;743;2996;621;4360
941;801073;Witnica;2208;9605;1433;13246
942;1005032;Chąśno;505;2125;533;3163
943;1005072;Łowicz;1372;5691;1254;8317
944;1438042;Radziejowice;837;3561;595;4993
945;1816072;Hyżne;1242;4722;950;6914
946;1816113;Sokołów Małopolski;3030;11596;2187;16813
947;2207032;Kwidzyn;2254;8999;1011;12264
948;215033;Jelcz-Laskowice;3479;17312;1880;22671
949;419033;Janowiec Wielkopolski;1603;7019;1207;9829
950;419063;Żnin;3928;17740;3049;24717
951;2466011;Gliwice;25052;141111;28757;194920
952;2474011;Siemianowice Śląskie;8470;46370;9498;64338
953;804011;Nowa Sól;5558;27809;5455;38822
954;1007012;Białaczów;1065;4022;1074;6161
955;1419092;Nowy Duninów;607;2878;488;3973
956;1420102;Raciąż;1394;5998;1404;8796
957;1606052;Wilków;811;3341;527;4679
958;1817032;Bukowsko;973;3764;687;5424
959;1817082;Zarszyn;1506;6499;1332;9337
960;2003032;Bielsk Podlaski;827;3924;2374;7125
961;216043;Polkowice;4626;20011;2524;27161
962;216062;Radwanice;814;3404;416;4634
963;217022;Kondratowice;694;3378;560;4632
964;462011;Grudziądz;13837;68349;12847;95033
965;463011;Toruń;27568;149528;27450;204546
966;404032;Kijewo Królewskie;823;3158;439;4420
967;1864011;Tarnobrzeg;6878;35841;6550;49269
968;2401031;Wojkowice;863;4980;1243;7086
969;2401021;Czeladź;4456;25986;5695;36137
970;2401062;Psary;1556;8118;1912;11586
971;614022;Baranów;577;2722;767;4066
972;2205062;Stężyca;2309;6407;817;9533
973;2206072;Nowa Karczma;1454;4499;611;6564
974;1018012;Bolesławiec;655;3022;633;4310
975;1402022;Ciechanów;1204;4902;810;6916
976;1402011;Ciechanów;6361;33546;5261;45168
977;1210032;Gródek nad Dunajcem;1973;6197;1112;9282
978;264011;Wrocław;76500;455102;99347;630949
979;202041;Piława Górna;993;4887;941;6821
980;3211043;Police;6447;32085;3554;42086
981;615011;Radzyń Podlaski;2449;11757;1719;15925
982;2209062;Miłoradz;612;2492;367;3471
983;2210032;Ostaszewo;577;2546;392;3515
984;2210052;Sztutowo;607;2618;376;3601
985;1018073;Wieruszów;2452;10260;1533;14245
986;1020031;Zgierz;7882;41656;8874;58412
987;1020062;Ozorków;1215;5373;1124;7712
988;1020092;Zgierz;1902;8686;1701;12289
989;1021042;Jeżów;532;2440;569;3541
990;1403072;Maciejowice;1242;4901;1177;7320
991;1403112;Sobolew;1514;5788;1138;8440
992;3212042;Przelewice;876;3901;634;5411
993;3214033;Dobrzany;832;3698;573;5103
994;2212032;Dębnica Kaszubska;1849;7021;948;9818
995;2212102;Ustka;1329;5489;767;7585
996;2213042;Bobowo;597;2043;256;2896
997;1410052;Sarnaki;741;3568;941;5250
998;2809042;Lubomino;647;2539;384;3570
999;2812011;Nowe Miasto Lubawskie;1830;7917;1383;11130
1000;2814063;Jeziorany;1345;5802;889;8036
1001;2811022;Janowo;553;1994;404;2951
1002;2810052;Sorkwity;925;3381;467;4773
1003;2812032;Grodziczno;1257;4197;754;6208
1004;2815042;Łukta;820;3173;445;4438
1005;2817062;Szczytno;2600;9956;1164;13720
1006;2814102;Purda;1346;5981;678;8005
1007;2803062;Rybno;1420;5211;826;7457
1008;2803052;Płośnica;1098;4175;829;6102
1009;2803022;Działdowo;2011;7014;1082;10107
1010;3001011;Chodzież;2612;13181;2511;18304
1011;3014022;Kwilcz;1142;4542;557;6241
1012;3014033;Międzychód;3027;13656;2002;18685
1013;3017052;Przygodzice;2017;8224;1312;11553
1014;3017063;Raszków;2207;8370;1349;11926
1015;3019052;Miasteczko Krajeńskie;561;2302;413;3276
1016;3020042;Gizałki;887;3251;462;4600
1017;3019083;Wyrzysk;2563;10255;1542;14360
1018;3021123;Pobiedziska;3135;12997;1871;18003
1019;3030043;Pyzdry;1249;5087;907;7243
1020;2602082;Sobków;1311;5664;1145;8120
1021;2602052;Oksa;760;3248;798;4806
1022;2601022;Gnojno;688;2924;768;4380
1023;2603053;Skalbmierz;1089;4699;1163;6951
1024;2604053;Daleszyce;2489;10551;1594;14634
1025;2604162;Raków;880;4082;962;5924
1026;2604182;Strawczyn;1939;7392;1000;10331
1027;2605052;Ruda Maleniecka;453;2145;609;3207
1028;2604192;Zagnańsk;1781;9522;1882;13185
1029;2609052;Łoniów;1222;5276;1143;7641
1030;2609062;Obrazów;1011;4681;1128;6820
1031;2606072;Tarłów;791;3914;1080;5785
1032;2611053;Wąchock;969;4815;1181;6965
1033;2606082;Wojciechowice;649;2995;733;4377
1034;2611011;Starachowice;6470;37018;8739;52227
1035;2607022;Bałtów;492;2463;626;3581
1036;2805052;Stare Juchy;761;2885;534;4180
1037;2613042;Radków;340;1675;520;2535
1038;2613052;Secemin;715;3401;931;5047
1039;2808043;Korsze;1729;7660;1260;10649
1040;2808011;Kętrzyn;3616;19991;3687;27294
1041;2403021;Ustroń;2067;10832;2589;15488
1042;2005022;Białowieża;254;1532;513;2299
1043;1805062;Krempna;334;1483;191;2008
1044;1602033;Głubczyce;3348;16475;3329;23152
1045;1602022;Branice;894;4844;1056;6794
1046;1211032;Czarny Dunajec;3899;15275;2613;21787
1047;1205102;Uście Gorlickie;1310;4602;661;6573
1048;221063;Mieroszów;989;5229;1118;7336
1049;208123;Radków;1343;6889;1219;9451
1050;206031;Piechowice;853;4766;843;6462
1051;1818053;Zaklików;1281;5999;1241;8521
1052;1609042;Komprachcice;1125;6584;1262;8971
1053;1609123;Tułowice;752;4080;568;5400
1054;1203013;Alwernia;1787;8926;1874;12587
1055;810011;Gozdnica;473;2388;492;3353
1056;2202023;Brusy;2954;9588;1464;14006
1057;2813032;Kowale Oleckie;912;3776;636;5324
1058;3025022;Krzykosy;1163;4629;716;6508
1059;2215092;Szemud;3397;10424;1193;15014
1060;2211043;Władysławowo;2483;10666;1478;14627
1061;3203063;Złocieniec;2647;12669;1983;17299
1062;2604133;Nowa Słupia;1368;6731;1464;9563
1063;205052;Paszowice;610;3042;482;4134
1064;1005092;Nieborów;1277;5889;1288;8454
1065;2007032;Miastkowo;832;2945;569;4346
1066;2007072;Śniadowo;956;3766;927;5649
1067;2014042;Szumowo;871;3319;739;4929
1068;1015012;Bolimów;668;2880;623;4171
1069;1609012;Chrząstowice;836;4768;970;6574
1070;2203032;Człuchów;2059;7621;1011;10691
1071;3203052;Wierzchowo;711;3210;497;4418
1072;2807021;Lubawa;1674;6656;1043;9373
1073;3021152;Suchy Las;2916;10507;1178;14601
1074;2605062;Słupia Konecka;518;2339;643;3500
1075;1017102;Wierzchlas;1071;4607;1022;6700
1076;1017072;Pątnów;1133;4275;918;6326
1077;1429053;Kosów Lacki;992;4454;1218;6664
1078;1416043;Brok;465;2065;461;2991
1079;3205072;Rewal;562;2624;412;3598
1080;2612012;Bogoria;1376;5369;1239;7984
1081;418132;Włocławek;1273;5549;886;7708
1082;2402011;Szczyrk;839;4179;850;5868
1083;608053;Kamionka;1106;4514;961;6581
1084;3212033;Lipiany;912;4457;736;6105
1085;1212042;Klucze;2187;10916;2247;15350
1086;1213093;Zator;1349;6139;1158;8646
1087;1215011;Jordanów;880;3973;673;5526
1088;1215042;Bystra-Sidzina;1409;4409;813;6631
1089;1215032;Budzów;1818;5814;1026;8658
1090;206062;Jeżów Sudecki;1180;5514;695;7389
1091;207011;Kamienna Góra;2901;14645;3182;20728
1092;409043;Strzelno;1929;8823;1501;12253
1093;619022;Hanna;424;2034;513;2971
1094;619062;Włodawa;928;4227;861;6016
1095;620122;Sułów;759;3536;1031;5326
1096;1412073;Halinów;3033;10593;1571;15197
1097;1412093;Kałuszyn;1013;4253;870;6136
1098;1407012;Garbatka-Letnisko;745;3775;845;5365
1099;1811073;Przecław;2254;8526;1542;12322
1100;1213072;Polanka Wielka;666;2815;562;4043
1101;1215063;Maków Podhalański;2822;11290;2479;16591
1102;1215092;Zembrzyce;953;3973;818;5744
1103;1216082;Skrzyszów;2492;9654;1583;13729
1104;410042;Sadki;1308;5133;745;7186
1105;3215043;Borne Sulinowo;1582;6850;1346;9778
1106;3217023;Człopa;913;3669;563;5145
1107;663011;Lublin;46588;251190;50778;348556
1108;2216022;Mikołajki Pomorskie;729;2711;346;3786
1109;2216013;Dzierzgoń;1684;6834;916;9434
1110;2216053;Sztum;3058;13682;1751;18491
1111;1413072;Szreńsk;767;3160;625;4552
1112;1436032;Przyłęk;1068;4321;1062;6451
1113;1408052;Wieliszew;2265;9784;1295;13344
1114;1409012;Chotcza;383;1718;536;2637
1115;1811102;Wadowice Górne;1424;4984;985;7393
1116;1812053;Nisko;3527;17049;2548;23124
1117;1812063;Rudnik nad Sanem;1519;7241;1360;10120
1118;1216112;Wierzchosławice;1851;7558;1542;10951
1119;1216153;Żabno;2879;13019;2462;18360
1120;210053;Olszyna;939;4781;827;6547
1121;414022;Dragacz;1709;7594;1618;10921
1122;414012;Bukowiec;955;3719;530;5204
1123;414063;Nowe;1698;7757;1345;10800
1124;3218043;Resko;1372;5943;1085;8400
1125;601011;Międzyrzec Podlaski;2683;12311;2056;17050
1126;601062;Kodeń;582;2460;703;3745
1127;1001042;Kleszczów;955;3278;501;4734
1128;1001083;Zelów;2287;10575;2183;15045
1129;1415052;Kadzidło;2246;7873;1305;11424
1130;1434041;Zielonka;2904;12470;2964;18338
1131;1813062;Medyka;1121;4519;713;6353
1132;1814042;Jawornik Polski;699;3078;833;4610
1133;1814073;Sieniawa;1237;4803;843;6883
1134;2401081;Sławków;1108;5349;1005;7462
1135;806013;Dobiegniew;1039;4935;935;6909
1136;806023;Drezdenko;2913;12802;2103;17818
1137;1008052;Ksawerów;954;4584;914;6452
1138;1606032;Pokój;780;3972;609;5361
1139;1606042;Świerczów;535;2557;489;3581
1140;1862011;Przemyśl;9076;46207;9635;64918
1141;2005011;Hajnówka;2590;14778;3178;20546
1142;2005082;Narew;449;2482;1085;4016
1143;606102;Siennica Różana;572;2932;737;4241
1144;607092;Wilkołaz;991;3867;860;5718
1145;807043;Sulęcin;2608;11857;1945;16410
1146;1010113;Wolbórz;1176;5594;1085;7855
1147;1010012;Aleksandrów;695;2934;832;4461
1148;1423042;Odrzywół;601;2741;701;4043
1149;1423082;Wieniawa;908;3790;866;5564
1150;1608062;Rudniki;1274;5803;1423;8500
1151;1608072;Zębowice;464;2802;575;3841
1152;1202042;Dębno;2486;9873;1693;14052
1153;1202072;Szczurowa;1446;6294;1393;9133
1154;1201063;Nowy Wiśnicz;2526;9106;1558;13190
1155;1201052;Łapanów;1424;5130;905;7459
1156;2404022;Dąbrowa Zielona;517;2677;721;3915
1157;608042;Jeziorzany;485;2083;535;3103
1158;608032;Firlej;1005;4012;942;5959
1159;608103;Ostrów Lubelski;835;3768;914;5517
1160;608122;Serniki;738;3008;727;4473
1161;809053;Nowogród Bobrzański;1496;7022;940;9458
1162;810082;Wymiarki;342;1788;289;2419
1163;1012072;Kodrąb;740;3225;692;4657
1164;1424072;Zatory;870;3135;693;4698
1165;1425052;Jedlińsk;2759;9932;1486;14177
1166;1609112;Tarnów Opolski;1379;7190;1355;9924
1167;1201072;Rzezawa;1992;7938;1318;11248
1168;1204023;Dąbrowa Tarnowska;3470;15184;2516;21170
1169;2010062;Milejczyce;288;1194;601;2083
1170;2010023;Drohiczyn;1088;4599;1272;6959
1171;2010042;Grodzisk;782;3027;978;4787
1172;2010072;Nurzec-Stacja;542;2718;1069;4329
1173;223062;Mietków;548;2709;497;3754
1174;223073;Sobótka;1961;9330;1608;12899
1175;3202053;Pełczyce;1378;5877;900;8155
1176;608132;Uścimów;514;2172;516;3202
1177;609082;Konopnica;2149;8892;1628;12669
1178;609052;Głusk;1650;6442;903;8995
1179;609072;Jastków;2211;8674;1440;12325
1180;609132;Wojciechów;992;4118;996;6106
1181;2201012;Borzytuchom;562;2099;280;2941
1182;2201023;Bytów;4524;17942;2291;24757
1183;1012142;Żytno;770;3623;1019;5412
1184;1014011;Sieradz;6055;31809;5493;43357
1185;1426062;Paprotnia;470;1774;473;2717
1186;3003072;Mieleszyn;704;2577;322;3603
1187;3004013;Borek Wielkopolski;1374;5452;938;7764
1188;3007022;Brzeziny;1044;4110;796;5950
1189;3010132;Wierzbinek;1435;5312;919;7666
1190;3007102;Szczytniki;1352;5540;1054;7946
1191;3008012;Baranów;1386;5724;805;7915
1192;3004042;Pępowo;1074;4195;788;6057
1193;3004033;Krobia;2178;9429;1542;13149
1194;3004052;Piaski;1556;6340;1008;8904
1195;3008062;Rychtal;632;2864;448;3944
1196;3009102;Osiek Mały;1149;4196;679;6024
1197;3009022;Babiak;1335;5717;1076;8128
1198;3010013;Golina;1833;8488;1235;11556
1199;3012052;Rozdrażew;986;3676;571;5233
1200;3011053;Śmigiel;3011;12614;1937;17562
1201;2411011;Racibórz;7349;41456;7690;56495
1202;2410042;Pawłowice;3075;13023;1472;17570
1203;2414042;Bojszowy;1134;4696;764;6594
1204;2413021;Miasteczko Śląskie;1099;5264;1121;7484
1205;2416032;Irządze;408;1851;548;2807
1206;2417032;Gilowice;1071;4451;841;6363
1207;1433053;Łochów;3076;12616;2321;18013
1208;1433082;Stoczek;840;3503;863;5206
1209;1806052;Raniżów;1290;5047;993;7330
1210;1208032;Kozłów;669;3290;827;4786
1211;1209062;Siepraw;1560;5916;903;8379
1212;406043;Radzyń Chełmiński;912;3530;523;4965
1213;406022;Gruta;1124;4742;746;6612
1214;3208011;Kołobrzeg;5959;33389;6540;45888
1215;3208033;Gościno;920;3692;579;5191
1216;3208042;Kołobrzeg;1827;8027;875;10729
1217;3208062;Siemyśl;655;2842;363;3860
1218;3209012;Będzino;1383;6292;796;8471
1219;613072;Sosnowica;407;1905;427;2739
1220;1426112;Wiśniew;1110;3779;777;5666
1221;1426092;Skórzec;1427;5235;999;7661
1222;1426102;Suchożebry;814;3179;729;4722
1223;1426132;Zbuczyn;1912;6818;1518;10248
1224;1204073;Szczucin;2138;9420;1788;13346
1225;1205072;Moszczenica;906;3287;679;4872
1226;2010092;Siemiatycze;916;4196;1325;6437
1227;2011013;Dąbrowa Białostocka;1778;8686;2142;12606
1228;2011022;Janów;749;2932;810;4491
1229;3204052;Osina;570;2125;296;2991
1230;609142;Wólka;2019;7056;1010;10085
1231;611011;Łuków;4992;22461;3297;30750
1232;611042;Krzywda;2121;7186;1419;10726
1233;1015052;Lipce Reymontowskie;550;2316;546;3412
1234;1427011;Sierpc;2699;13760;2336;18795
1235;1427062;Szczutowo;753;3009;657;4419
1236;1429032;Ceranów;414;1832;577;2823
1237;1802032;Dydnia;1393;5522;1127;8042
1238;1206132;Sułoszowa;1029;3919;885;5833
1239;2012052;Raczki;1089;4154;767;6010
1240;401052;Bądkowo;746;3132;634;4512
1241;401042;Aleksandrów Kujawski;2898;12448;1865;17211
1242;402011;Brodnica;4575;20245;3189;28009
1243;402062;Bartniczka;914;3334;526;4774
1244;402073;Jabłonowo Pomorskie;1546;6381;1121;9048
1245;3205023;Gryfice;3682;17587;2759;24028
1246;3207033;Kamień Pomorski;2034;10806;1840;14680
1247;612012;Chodel;1322;4786;995;7103
1248;612072;Wilków;747;3209;845;4801
1249;2204022;Cedry Wielkie;1265;4854;522;6641
1250;2205012;Chmielno;1570;4645;626;6841
1251;1017022;Czarnożyły;754;3146;714;4614
1252;1428042;Młodzieszyn;957;3919;839;5715
1253;1428062;Rybno;592;2443;521;3556
1254;1206152;Wielka Wieś;1814;7693;1258;10765
1255;1207032;Dobra;1842;6623;1230;9695
1256;1207021;Mszana Dolna;1546;5606;1029;8181
1257;1207102;Niedźwiedź;1586;4863;670;7119
1258;1207122;Tymbark;1272;4267;699;6238
1259;2013062;Kulesze Kościelne;554;2181;564;3299
1260;2013052;Kobylin-Borzymy;577;2186;683;3446
1261;403062;Osielsko;1955;7423;773;10151
1262;3206072;Stare Czarnowo;1254;7323;751;9328
1263;3206083;Trzcińsko-Zdrój;925;4018;738;5681
1264;3015053;Opalenica;2751;11590;1683;16024
1265;203011;Głogów;8996;45335;6437;60768
1266;2801063;Sępopol;1024;4818;898;6740
1267;3214102;Stargard;2352;9683;1295;13330
1268;3020033;Dobrzyca;1424;5814;953;8191
1269;2009022;Giby;400;1801;482;2683
1270;2001062;Płaska;403;1772;448;2623
1271;1218102;Wieprz;2657;10220;1546;14423
1272;211032;Rudna;1292;5318;893;7503
1273;415042;Lubicz;3571;13740;1458;18769
1274;415032;Czernikowo;1731;6181;970;8882
1275;415052;Łubianka;1207;4404;646;6257
1276;415072;Obrowo;2596;9131;999;12726
1277;601082;Leśna Podlaska;766;2913;613;4292
1278;601162;Terespol;1152;4914;1149;7215
1279;801011;Kostrzyn nad Odrą;3033;12902;2079;18014
1280;1416102;Wąsewo;750;3004;750;4504
1281;1435053;Wyszków;6668;28026;4186;38880
1282;1815052;Wielopole Skrzyńskie;1603;5513;1176;8292
1283;2001052;Nowinka;516;2051;443;3010
1284;2001072;Sztabin;877;3647;935;5459
1285;417022;Dębowa Łąka;594;2216;411;3221
1286;418022;Baruchowo;623;2565;514;3702
1287;2462011;Bytom;22956;121087;26745;170788
1288;801052;Lubiszyn;1193;5021;735;6949
1289;1005011;Łowicz;4161;21257;3855;29273
1290;1005022;Bielawy;764;3875;1089;5728
1291;1005102;Zduny;854;4026;1159;6039
1292;1418023;Konstancin-Jeziorna;3712;17078;3768;24558
1293;1419042;Bulkowo;972;3941;803;5716
1294;1419063;Gąbin;1637;7749;1616;11002
1295;1465011;Warszawa;222712;1186095;295794;1704601
1296;1602013;Baborów;853;4571;881;6305
1297;2002032;Dobrzyniewo Duże;1441;6053;1106;8600
1298;215042;Oława;2518;10422;1601;14541
1299;419043;Łabiszyn;1763;7081;933;9777
1300;419022;Gąsawa;845;3766;614;5225
1301;2472011;Ruda Śląska;19943;104394;19682;144019
1302;2476011;Świętochłowice;8568;43469;9156;61193
1303;2402022;Bestwina;1616;7437;1366;10419
1304;603032;Chełm;2461;11197;1596;15254
1305;603102;Sawin;878;3928;813;5619
1306;604011;Hrubieszów;2649;13454;2407;18510
1307;604052;Mircze;1089;5186;1499;7774
1308;803042;Pszczew;677;3059;470;4206
1309;1603062;Reńska Wieś;1110;5909;1343;8362
1310;1818011;Stalowa Wola;8858;48247;7852;64957
1311;2002152;Zawady;483;1979;518;2980
1312;2002143;Zabłudów;1357;6183;1467;9007
1313;2004043;Rajgród;905;3765;772;5442
1314;219021;Świebodzice;3120;16514;3223;22857
1315;404062;Stolno;938;3693;527;5158
1316;614011;Puławy;6501;33419;8045;47965
1317;615032;Czemierniki;767;3065;738;4570
1318;2205023;Kartuzy;6430;23010;3591;33031
1319;2206011;Kościerzyna;4116;16758;2778;23652
1320;2206062;Lipusz;737;2449;341;3527
1321;1401032;Radzanów;764;2514;563;3841
1322;1401013;Białobrzegi;1716;7552;1157;10425
1323;1401022;Promna;928;3890;858;5676
1324;1401042;Stara Błotnica;1019;3543;655;5217
1325;1401063;Wyśmierzyce;486;2000;414;2900
1326;1402082;Regimin;863;3557;646;5066
1327;1807052;Korczyna;1858;7857;1581;11296
1328;262011;Legnica;14076;75753;13694;103523
1329;202073;Niemcza;800;4188;862;5850
1330;3209082;Świeszyno;1128;4745;583;6456
1331;3211033;Nowe Warpno;325;1530;203;2058
1332;615042;Kąkolewnica;1514;5630;1241;8385
1333;616011;Dęblin;2448;12993;2351;17792
1334;616062;Ułęż;482;2414;594;3490
1335;2211052;Kosakowo;2042;8131;763;10936
1336;1020043;Aleksandrów Łódzki;4391;20697;3784;28872
1337;1021011;Brzeziny;1778;9108;1546;12432
1338;1021022;Brzeziny;950;3836;790;5576
1339;1403062;Łaskarzew;975;3689;670;5334
1340;1403122;Trojanów;1287;5092;1231;7610
1341;1210152;Rytro;685;2566;436;3687
1342;617052;Trawniki;1533;6323;1293;9149
1343;617042;Rybczewice;520;2519;808;3847
1344;618032;Jarczów;538;2371;711;3620
1345;2212092;Smołdzino;531;2564;366;3461
1346;2263011;Słupsk;12726;69398;13388;95512
1347;1411032;Karniewo;933;3602;733;5268
1348;2813043;Olecko;3687;15959;2633;22279
1349;2814023;Biskupiec;2878;14412;2147;19437
1350;2813052;Świętajno;678;2920;483;4081
1351;2815022;Dąbrówno;801;3175;488;4464
1352;2817043;Pasym;943;3925;538;5406
1353;2814112;Stawiguda;1623;6600;525;8748
1354;2861011;Elbląg;17567;91227;15818;124612
1355;2818012;Banie Mazurskie;613;2822;625;4060
1356;2803032;Iłowo-Osada;1335;5105;883;7323
1357;3016013;Oborniki;5606;23808;3238;32652
1358;3015012;Kuślin;1060;4008;576;5644
1359;3016032;Ryczywół;1396;5257;701;7354
1360;3013052;Święciechowa;1286;5198;707;7191
1361;3018042;Kobyla Góra;1077;4497;641;6215
1362;3024022;Duszniki;1503;6006;887;8396
1363;3024053;Ostroróg;901;3644;543;5088
1364;3024032;Kaźmierz;1434;5531;787;7752
1365;3026043;Śrem;6708;29913;4332;40953
1366;3023072;Strzałkowo;1926;8227;1144;11297
1367;3027042;Kawęczyn;910;3544;736;5190
1368;3026012;Brodnica;859;3396;421;4676
1369;3028033;Gołańcz;1599;5968;888;8455
1370;3030033;Nekla;1257;5169;634;7060
1371;3028072;Wągrowiec;2285;8407;1066;11758
1372;3031042;Lipka;1283;5040;723;7046
1373;3031082;Złotów;2064;7988;943;10995
1374;3003042;Kiszkowo;904;3827;534;5265
1375;2605022;Gowarczów;788;3425;697;4910
1376;2604082;Łopuszno;1561;6486;1209;9256
1377;2606032;Lipnik;795;3957;949;5701
1378;2607043;Ćmielów;1131;5362;1346;7839
1379;2611022;Brody;1656;7328;1683;10667
1380;2611042;Pawłów;2688;10623;2185;15496
1381;2607053;Kunów;1544;7576;1549;10669
1382;2804022;Godkowo;577;2336;480;3393
1383;2805022;Ełk;2498;9661;1340;13499
1384;2613032;Moskorzew;369;1810;537;2716
1385;2809032;Lidzbark Warmiński;1368;6347;960;8675
1386;2806042;Giżycko;1849;8373;1149;11371
1387;2806083;Ryn;895;4208;711;5814
1388;2814052;Gietrzwałd;1039;4423;535;5997
1389;2403011;Cieszyn;4899;25798;5447;36144
1390;2001043;Lipsk;771;3773;918;5462
1391;1817042;Komańcza;701;3589;579;4869
1392;1610023;Głogówek;1922;9503;2164;13589
1393;1211042;Czorsztyn;1279;4722;771;6772
1394;225011;Zawidów;505;2654;463;3622
1395;208133;Stronie Śląskie;1054;5811;966;7831
1396;1609022;Dąbrowa;1139;5911;1082;8132
1397;225063;Węgliniec;1318;6382;1132;8832
1398;1415022;Czarnia;580;1756;369;2705
1399;1415102;Rzekuń;1763;7302;1056;10121
1400;2004022;Grajewo;1188;4133;815;6136
1401;2004011;Grajewo;3438;16519;2373;22330
1402;2410022;Kobiór;895;3919;691;5505
1403;3025043;Środa Wielkopolska;4907;22580;3416;30903
1404;3263011;Świnoujście;5138;30438;5933;41509
1405;2211023;Jastarnia;423;1898;296;2617
1406;1010093;Sulejów;2764;11644;2085;16493
1407;2007092;Zbójna;775;2952;715;4442
1408;2416073;Pilica;1277;6375;1595;9247
1409;3022023;Jutrosin;1359;5028;791;7178
1410;2471011;Piekary Śląskie;7782;41643;8761;58186
1411;1004063;Piątek;923;4293;1037;6253
1412;2202052;Konarzyny;483;1550;222;2255
1413;1416072;Ostrów Mazowiecka;2254;8443;1893;12590
1414;2215042;Choczewo;1086;4186;587;5859
1415;1423012;Borkowice;682;3297;839;4818
1416;1430012;Chlewiska;931;4216;1113;6260
1417;3010092;Skulsk;1217;4776;844;6837
1418;464011;Włocławek;15702;84452;15689;115843
1419;802072;Maszewo;499;2078;365;2942
1420;805013;Cybinka;1189;4815;769;6773
1421;1404011;Gostynin;2791;14293;2523;19607
1422;1405043;Grodzisk Mazowiecki;7329;30163;5562;43054
1423;1406012;Belsk Duży;1036;4622;999;6657
1424;1810022;Białobrzegi;1492;5571;1093;8156
1425;1211142;Szaflary;2017;7349;1218;10584
1426;1212062;Trzyciąż;1164;4614;1200;6978
1427;1213052;Osiek;1329;5472;1065;7866
1428;1213011;Oświęcim;4995;25855;6798;37648
1429;411022;Bytoń;556;2501;610;3667
1430;3214082;Marianowo;566;2319;350;3235
1431;3214113;Suchań;679;3160;514;4353
1432;618123;Tyszowce;955;4051;1027;6033
1433;620072;Nielisz;823;3899;1132;5854
1434;2213072;Osieczna;456;1624;258;2338
1435;2213093;Skarszewy;2838;10495;1359;14692
1436;1412062;Dobre;937;3848;841;5626
1437;1406113;Warka;3052;13578;2390;19020
1438;1213043;Kęty;5285;24786;4502;34573
1439;1216103;Tuchów;3086;11920;2339;17345
1440;1216013;Ciężkowice;2085;7763;1488;11336
1441;208051;Polanica-Zdrój;756;4646;1227;6629
1442;412032;Rogowo;866;3306;672;4844
1443;3216062;Świdwin;1026;4481;636;6143
1444;2215011;Reda;3215;13638;1160;18013
1445;2215052;Gniewino;1513;5157;571;7241
1446;2215031;Wejherowo;8622;34689;6100;49411
1447;2215021;Rumia;7557;34681;5188;47426
1448;2215102;Wejherowo;5407;17754;1853;25014
1449;1413042;Radzanów;662;2353;581;3596
1450;1436012;Kazanów;885;3226;749;4860
1451;1436053;Zwoleń;2496;11099;2048;15643
1452;1812042;Krzeszów;713;3173;719;4605
1453;209052;Legnickie Pole;731;3526;675;4932
1454;3217052;Wałcz;2183;8930;1148;12261
1455;811082;Trzebiel;937;4041;679;5657
1456;1062011;Piotrków Trybunalski;11090;54358;10663;76111
1457;1415042;Goworowo;1452;5932;1414;8798
1458;1415012;Baranowo;1174;4492;1138;6804
1459;1415072;Łyse;1645;5877;1075;8597
1460;1434102;Strachówka;496;2017;485;2998
1461;1434021;Marki;4976;18096;2391;25463
1462;1434011;Kobyłka;3501;14126;2196;19823
1463;1434113;Tłuszcz;3458;13792;1970;19220
1464;1813032;Fredropol;985;3858;740;5583
1465;1814053;Kańczuga;2036;8654;1874;12564
1466;1420082;Nowe Miasto;737;3336;676;4749
1467;1420021;Raciąż;729;3263;480;4472
1468;1421011;Piastów;3549;16634;3260;23443
1469;1607022;Kamiennik;473;2270;411;3154
1470;1607082;Pakosławice;516;2797;442;3755
1471;1820022;Gorzyce;2199;10111;1371;13681
1472;1821052;Solina;755;3696;678;5129
1473;2004032;Radziłów;826;3360;867;5053
1474;2005052;Dubicze Cerkiewne;152;933;676;1761
1475;2006032;Kolno;1747;5822;1345;8914
1476;2006022;Grabowo;692;2495;525;3712
1477;219083;Żarów;1958;9265;1512;12735
1478;2403113;Strumień;2149;9049;1468;12666
1479;2404063;Koniecpol;1405;7138;1570;10113
1480;606052;Krasnystaw;1279;6017;1295;8591
1481;808053;Świebodzin;4874;22219;3482;30575
1482;808063;Zbąszynek;1337;6108;914;8359
1483;1010032;Gorzkowice;1505;5852;1232;8589
1484;1010052;Łęki Szlacheckie;639;2454;649;3742
1485;1010042;Grabica;996;4017;837;5850
1486;1010102;Wola Krzysztoporska;2107;8121;1625;11853
1487;1011052;Wartkowice;989;4550;1020;6559
1488;1201011;Bochnia;4978;21610;3752;30340
1489;2404052;Kłomnice;1938;9711;2124;13773
1490;2404152;Rędziny;1475;7244;1447;10166
1491;3201011;Białogard;3768;18014;3125;24907
1492;608011;Lubartów;2982;15304;2311;20597
1493;608063;Kock;1153;4614;1019;6786
1494;809063;Sulechów;3902;19822;2936;26660
1495;1011043;Uniejów;949;4967;1246;7162
1496;1011022;Pęczniew;519;2358;597;3474
1497;1424043;Pułtusk;3847;17343;2772;23962
1498;1425033;Iłża;2267;10724;2305;15296
1499;1611053;Strzelce Opolskie;4323;23230;4475;32028
1500;1611012;Izbicko;771;3980;830;5581
1501;609022;Borzechów;616;2511;580;3707
1502;609013;Bełżyce;2192;9728;1806;13726
1503;609033;Bychawa;1980;8411;1898;12289
1504;609112;Niemce;3317;13325;2076;18718
1505;810043;Iłowa;1057;5118;953;7128
1506;2201092;Trzebielino;720;2897;403;4020
1507;1012132;Wielgomłyny;756;3317;783;4856
1508;1013023;Biała Rawska;1832;8064;1710;11606
1509;1426012;Domanice;466;1806;371;2643
1510;3007072;Mycielin;766;3375;659;4800
1511;3008042;Łęka Opatowska;993;3703;578;5274
1512;3006043;Żerków;1861;7438;1189;10488
1513;3004063;Pogorzela;947;3727;584;5258
1514;3010022;Grodziec;965;3661;660;5286
1515;3012023;Kobylin;1433;5720;957;8110
1516;2405032;Gierałtowice;1667;7622;1634;10923
1517;2407072;Pawonków;1030;4649;879;6558
1518;2407011;Lubliniec;3506;17573;3361;24440
1519;2407032;Ciasna;1205;5579;1103;7887
1520;2408042;Ornontowice;941;4158;653;5752
1521;2412032;Jejkowice;644;2500;381;3525
1522;2412052;Świerklany;2034;8125;1353;11512
1523;2413011;Kalety;1071;5913;1219;8203
1524;2415041;Wodzisław Śląski;6596;32727;7207;46530
1525;2417022;Czernichów;951;4635;941;6527
1526;2416011;Poręba;1173;6292;1415;8880
1527;2417082;Łodygowice;2261;9929;1800;13990
1528;2417092;Milówka;1673;6879;1321;9873
1529;2417132;Świnna;1327;5298;1046;7671
1530;2417052;Koszarawa;383;1705;318;2406
1531;2417072;Łękawica;697;2799;502;3998
1532;1432053;Łomianki;4188;16340;2623;23151
1533;1806062;Dzikowiec;1162;4521;835;6518
1534;1806032;Majdan Królewski;1813;7156;1233;10202
1535;1805042;Jasło;2791;12487;2392;17670
1536;1208042;Książ Wielki;808;3729;1037;5574
1537;407022;Dąbrowa Biskupia;878;3685;563;5126
1538;613062;Siemień;723;3182;851;4756
1539;1611033;Kolonowskie;696;4428;1019;6143
1540;1205011;Gorlice;3946;20189;3848;27983
1541;1205052;Lipinki;1138;4686;984;6808
1542;1205082;Ropa;1097;3505;630;5232
1543;2201102;Tuchomie;841;2961;310;4112
1544;2203023;Czarne;1615;6857;948;9420
1545;1014052;Burzenin;854;3964;853;5671
1546;1014082;Sieradz;1815;7449;1400;10664
1547;1015062;Maków;988;4236;1012;6236
1548;1802013;Brzozów;4687;18782;3222;26691
1549;1206063;Krzeszowice;4762;22701;4935;32398
1550;1206103;Skała;1733;7023;1385;10141
1551;1206113;Skawina;6741;30371;5497;42609
1552;2011102;Szudziałowo;430;2069;765;3264
1553;2012082;Szypliszki;664;2696;559;3919
1554;402032;Brodnica;1483;5691;633;7807
1555;3205032;Karnice;733;3074;455;4262
1556;2204082;Trąbki Wielkie;2075;7465;852;10392
1557;2204042;Pruszcz Gdański;4916;18684;2307;25907
1558;1016112;Żelechlinek;571;2197;616;3384
1559;1016011;Tomaszów Mazowiecki;9181;45577;9312;64070
1560;1016102;Ujazd;1268;5786;1044;8098
1561;1804092;Rokietnica;759;2980;650;4389
1562;1804032;Chłopice;866;3800;754;5420
1563;1206162;Zabierzów;3631;16708;3332;23671
1564;2014022;Kołaki Kościelne;390;1598;360;2348
1565;402102;Zbiczno;797;3365;510;4672
1566;403012;Białe Błota;3891;15074;1686;20651
1567;405043;Kowalewo Pomorskie;2003;8099;1410;11512
1568;3206053;Mieszkowice;1227;5342;831;7400
1569;3206063;Moryń;699;3316;452;4467
1570;205032;Męcinka;899;3773;627;5299
1571;3020052;Gołuchów;1761;7129;1151;10041
1572;2806062;Miłki;685;2713;385;3783
1573;202021;Dzierżoniów;4291;24942;5780;35013
1574;2467011;Jastrzębie-Zdrój;14170;67006;11687;92863
1575;2415062;Gorzyce;3281;14163;2854;20298
1576;2403122;Zebrzydowice;2137;8848;1568;12553
1577;1219043;Niepołomice;4016;16884;2687;23587
1578;1219022;Gdów;3161;11750;1791;16702
1579;212013;Gryfów Śląski;1385;7447;1407;10239
1580;415092;Zławieś Wielka;2536;8976;1091;12603
1581;416032;Kęsowo;828;3227;435;4490
1582;602022;Aleksandrów;655;2190;444;3289
1583;1814092;Zarzecze;1310;5243;975;7528
1584;1816033;Boguchwała;3159;13411;2587;19157
1585;2001011;Augustów;4581;21998;4264;30843
1586;418011;Kowal;444;2519;434;3397
1587;2465011;Dąbrowa Górnicza;15522;91740;16546;123808
1588;602032;Biłgoraj;2265;9152;1612;13029
1589;602092;Łukowa;753;2933;671;4357
1590;802022;Bobrowice;560;2456;406;3422
1591;803012;Bledzew;728;3326;565;4619
1592;803032;Przytoczna;824;4232;585;5641
1593;1004032;Góra Świętej Małgorzaty;694;2932;779;4405
1594;1004052;Łęczyca;1321;6228;1428;8977
1595;1005052;Kiernozia;529;2362;597;3488
1596;1418013;Góra Kalwaria;4104;17964;2989;25057
1597;1418043;Piaseczno;14462;52451;8040;74953
1598;1464011;Siedlce;11886;55817;9056;76759
1599;1817062;Tyrawa Wołoska;383;1386;211;1980
1600;2002093;Supraśl;2045;9487;1596;13128
1601;214062;Oleśnica;2106;9067;1178;12351
1602;214073;Syców;2632;12000;1772;16404
1603;2207022;Gardeja;1705;5978;813;8496
1604;2207052;Ryjewo;1105;4490;586;6181
1605;2470011;Mysłowice;10807;56928;10027;77762
1606;2478011;Zabrze;22737;123095;25607;171439
1607;603052;Dubienka;330;1780;457;2567
1608;603072;Leśniowice;560;2585;652;3797
1609;603142;Żmudź;534;2264;430;3228
1610;1006113;Tuszyn;1757;8581;1676;12014
1611;1419142;Staroźreby;1308;5138;1024;7470
1612;1419132;Stara Biała;1926;7750;1106;10782
1613;1603052;Polska Cerekiew;524;3077;730;4331
1614;1819043;Strzyżów;3272;14886;2898;21056
1615;2002123;Tykocin;1034;4537;1150;6721
1616;2003062;Orla;305;1626;1121;3052
1617;216013;Chocianów;2101;9597;1433;13131
1618;217043;Strzelin;3121;16058;2924;22103
1619;217032;Przeworno;781;3613;714;5108
1620;404052;Papowo Biskupie;783;3113;490;4386
1621;2402043;Czechowice-Dziedzice;6994;31837;5495;44326
1622;2402082;Porąbka;2552;11120;2147;15819
1623;614043;Kazimierz Dolny;993;4660;1159;6812
1624;614062;Kurów;1182;5529;1163;7874
1625;2205042;Sierakowice;4369;12249;1468;18086
1626;1019023;Szadek;1146;5215;1143;7504
1627;1433092;Wierzbno;450;2100;621;3171
1628;1401052;Stromiec;1037;3955;750;5742
1629;1402042;Gołymin-Ośrodek;664;2752;488;3904
1630;1402033;Glinojeck;1409;5660;1096;8165
1631;1805082;Osiek Jasielski;916;3742;713;5371
1632;1807033;Iwonicz-Zdrój;1804;7620;1365;10789
1633;1209082;Tokarnia;1712;5684;885;8281
1634;1209073;Sułkowice;2534;9781;1447;13762
1635;1210092;Łącko;3437;10643;1749;15829
1636;226052;Zagrodno;860;4052;698;5610
1637;407092;Złotniki Kujawskie;1462;6763;972;9197
1638;615022;Borki;1103;4078;867;6048
1639;616022;Kłoczew;1316;4866;1179;7361
1640;2209073;Nowy Staw;1383;5803;964;8150
1641;1021032;Dmosin;633;2951;750;4334
1642;1403082;Miastków Kościelny;831;3266;751;4848
1643;1809053;Narol;1320;5833;1448;8601
1644;1210122;Nawojowa;1718;5288;749;7755
1645;1211011;Nowy Targ;5470;24110;4388;33968
1646;3212053;Pyrzyce;3030;14516;2395;19941
1647;618042;Krynice;505;2198;647;3350
1648;618063;Łaszczów;958;4486;1159;6603
1649;618112;Tomaszów Lubelski;2229;9478;1740;13447
1650;2213031;Starogard Gdański;7783;33997;5995;47775
1651;2213082;Osiek;346;1710;333;2389
1652;1410032;Olszanka;525;2153;507;3185
1653;1411073;Różan;688;3206;596;4490
1654;1411022;Czerwonka;454;1890;423;2767
1655;2810011;Mrągowo;3092;15759;2512;21363
1656;2811032;Kozłowo;1266;4468;615;6349
1657;3013022;Lipno;1499;5397;599;7495
1658;3019062;Szydłowo;1569;6106;697;8372
1659;3018073;Ostrzeszów;4004;17136;2750;23890
1660;3020022;Czermin;850;3482;513;4845
1661;3021052;Dopiewo;4076;13970;1513;19559
1662;3021083;Kostrzyn;3221;12935;1808;17964
1663;3021021;Puszczykowo;1395;6781;1227;9403
1664;3021132;Rokietnica;2653;8891;1046;12590
1665;3023083;Zagórów;1591;6520;1170;9281
1666;3024073;Szamotuły;4662;21209;3452;29323
1667;3023032;Orchowo;686;2805;444;3935
1668;3027011;Turek;3885;20372;3872;28129
1669;3027062;Przykona;753;3005;553;4311
1670;3023052;Powidz;298;1570;328;2196
1671;3031062;Tarnówka;570;2233;329;3132
1672;3031011;Złotów;2660;12496;2020;17176
1673;3030023;Miłosław;1710;7655;1166;10531
1674;3029033;Wolsztyn;5199;21730;3367;30296
1675;2603012;Bejsce;576;3124;872;4572
1676;2604033;Chęciny;2324;10698;1788;14810
1677;2604023;Bodzentyn;1891;8386;1694;11971
1678;2606012;Baćkowice;796;3548;808;5152
1679;2608022;Kije;655;3054;815;4524
1680;2804032;Gronowo Elbląskie;889;3656;414;4959
1681;2612073;Staszów;3742;17711;3520;24973
1682;2805032;Kalinowo;1339;4930;766;7035
1683;2814072;Jonkowo;1417;5651;614;7682
1684;2005092;Narewka;389;2623;898;3910
1685;1607073;Paczków;1858;9128;1629;12615
1686;1211072;Lipnica Wielka;1292;3957;571;5820
1687;225033;Bogatynia;3737;18283;2658;24678
1688;212043;Mirsk;1401;7081;1256;9738
1689;210033;Leśna;1546;7374;1283;10203
1690;3006013;Jaraczewo;1481;5892;968;8341
1691;2061011;Białystok;40583;213055;39650;293288
1692;1609103;Prószków;1266;6846;1391;9503
1693;1816122;Świlcza;2596;10773;2083;15452
1694;1063011;Skierniewice;7037;34406;5785;47228
1695;225043;Pieńsk;1437;7106;1064;9607
1696;3006023;Jarocin;7200;32814;5576;45590
1697;2262011;Gdynia;33502;178683;40516;252701
1698;1815012;Iwierzyce;1284;5092;981;7357
1699;3011011;Kościan;3322;17056;3222;23600
1700;3011032;Kościan;2696;11834;1636;16166
1701;2413082;Tworóg;1096;5532;1186;7814
1702;2604153;Pierzchnica;797;3292;776;4865
1703;1019011;Zduńska Wola;6477;31906;5910;44293
1704;2007022;Łomża;1737;6680;1276;9693
1705;1661011;Opole;16014;95550;19308;130872
1706;2203062;Przechlewo;1081;4538;636;6255
1707;3217033;Mirosławiec;1049;4078;548;5675
1708;2801052;Górowo Iławeckie;1342;5666;870;7878
1709;3010052;Kramsk;1943;7516;1285;10744
1710;3010112;Stare Miasto;2051;7818;1041;10910
1711;2416063;Ogrodzieniec;1273;6823;1595;9691
1712;2413031;Radzionków;3083;16924;2931;22938
1713;2201032;Czarna Dąbrówka;1131;4087;558;5776
1714;2261011;Gdańsk;60669;327201;70955;458825
1715;1420043;Czerwińsk nad Wisłą;1293;5362;1159;7814
1716;2408011;Łaziska Górne;3179;15868;2781;21828
1717;861011;Gorzów Wielkopolski;17201;90597;15710;123508
1718;801062;Santok;1390;6227;803;8420
1719;1407022;Głowaczów;1187;5037;1153;7377
1720;2201052;Lipnica;930;3580;558;5068
1721;407063;Kruszwica;2996;14522;2583;20101
1722;409022;Jeziora Wielkie;788;3611;654;5053
1723;1816063;Głogów Małopolski;2902;11528;1917;16347
1724;2602093;Wodzisław;1033;5000;1329;7362
1725;3007053;Koźminek;1246;5357;955;7558
1726;1807072;Miejsce Piastowe;2111;8934;1735;12780
1727;1807062;Krościenko Wyżne;893;3323;548;4764
1728;1404032;Pacyna;506;2692;707;3905
1729;1405062;Żabia Wola;1452;5467;859;7778
1730;1809072;Stary Dzików;737;3019;676;4432
1731;1214053;Proszowice;2514;11828;2333;16675
1732;1214042;Pałecznica;617;2405;600;3622
1733;1214062;Radziemice;555;2335;576;3466
1734;206052;Janowice Wielkie;554;3227;505;4286
1735;206092;Stara Kamienica;813;3997;503;5313
1736;411042;Osięciny;1223;5643;1162;8028
1737;411032;Dobre;792;3979;778;5549
1738;2463011;Chorzów;16573;84607;19660;120840
1739;620062;Miączyn;1003;4101;1025;6129
1740;620052;Łabunie;1068;4380;859;6307
1741;2213062;Lubichowo;1183;4269;642;6094
1742;1411082;Rzewnie;455;1845;417;2717
1743;1406083;Nowe Miasto nad Pilicą;1017;5765;1493;8275
1744;1406092;Pniewy;793;3232;653;4678
1745;1407042;Grabów nad Pilicą;733;2608;581;3922
1746;1213023;Brzeszcze;3184;15800;3069;22053
1747;1216063;Ryglice;2277;8035;1642;11954
1748;411053;Piotrków Kujawski;1503;6844;1235;9582
1749;411072;Topólka;763;3501;701;4965
1750;3216052;Sławoborze;714;3081;456;4251
1751;3216042;Rąbino;633;2786;487;3906
1752;620012;Adamów;881;3475;873;5229
1753;2215082;Łęczyce;2529;8296;907;11732
1754;2216042;Stary Targ;1164;4729;605;6498
1755;1413032;Lipowiec Kościelny;937;3420;748;5105
1756;1413052;Strzegowo;1284;5473;1225;7982
1757;1413092;Wieczfnia Kościelna;771;2882;523;4176
1758;1414032;Leoncin;856;3807;708;5371
1759;1811092;Tuszów Narodowy;1546;6103;1163;8812
1760;1216122;Wietrzychowice;651;2822;731;4204
1761;209042;Kunice;973;4270;565;5808
1762;209062;Miłkowice;906;4293;708;5907
1763;210042;Lubań;1158;5175;679;7012
1764;414052;Lniano;717;2890;429;4036
1765;811072;Przewóz;562;2317;362;3241
1766;811063;Lubsko;2975;14012;2331;19318
1767;811092;Tuplice;509;2461;398;3368
1768;812023;Szlichtyngowa;949;3676;504;5129
1769;1001032;Drużbice;778;3480;721;4979
1770;1001022;Bełchatów;1644;7297;1225;10166
1771;1409042;Rzeczniów;670;3270;835;4775
1772;1813102;Żurawica;2260;9859;1663;13782
1773;1814022;Adamówka;750;2750;584;4084
1774;604072;Uchanie;674;3385;906;4965
1775;806043;Strzelce Krajeńskie;2863;12788;1930;17581
1776;1009013;Działoszyn;2055;9179;1808;13042
1777;1422011;Przasnysz;2790;12391;2014;17195
1778;1606023;Namysłów;3745;18584;3417;25746
1779;1820043;Nowa Dęba;2665;13403;2486;18554
1780;2005032;Czeremcha;413;2323;762;3498
1781;219072;Świdnica;2721;12985;1942;17648
1782;220033;Trzebnica;3773;16585;2636;22994
1783;2404142;Przyrów;530;2844;694;4068
1784;607042;Gościeradów;1235;5059;1134;7428
1785;808042;Szczaniec;700;2828;405;3933
1786;1422052;Krasne;660;2774;542;3976
1787;1422072;Przasnysz;1408;5169;1038;7615
1788;1424032;Pokrzywnica;891;3457;672;5020
1789;1609052;Łubniany;1327;6867;1409;9603
1790;1202033;Czchów;1876;6824;1250;9950
1791;1201042;Lipnica Murowana;1082;3771;671;5524
1792;2006053;Stawiski;1104;4424;970;6498
1793;2006062;Turośl;1011;3225;705;4941
1794;2007052;Piątnica;1882;7618;1536;11036
1795;2007082;Wizna;709;2927;777;4413
1796;221042;Czarny Bór;790;3516;533;4839
1797;221031;Szczawno-Zdrój;1007;5868;1615;8490
1798;222013;Brzeg Dolny;2206;11926;2076;16208
1799;608022;Abramów;670;2793;763;4226
1800;809092;Zabór;669;2725;350;3744
1801;810073;Szprotawa;3408;15795;2648;21851
1802;1012022;Dobryszyce;649;2765;478;3892
1803;1012102;Masłowice;646;2895;760;4301
1804;1012062;Kobiele Wielkie;752;3127;624;4503
1805;1012053;Kamieńsk;1035;4404;858;6297
1806;1425022;Gózd;1485;5390;775;7650
1807;1425112;Wierzbica;1777;7242;1254;10273
1808;1609092;Popielów;1139;6088;1305;8532
1809;1203033;Chrzanów;6213;34543;7479;48235
1810;1203053;Trzebinia;4770;24466;5382;34618
1811;1204032;Gręboszów;361;2391;611;3363
1812;2010011;Siemiatycze;2143;11129;1765;15037
1813;3201033;Karlino;1614;6723;936;9273
1814;3202012;Bierzwnik;756;3487;652;4895
1815;3202023;Choszczno;3508;16483;2493;22484
1816;810062;Niegosławice;816;3258;564;4638
1817;1426032;Kotuń;1509;5901;1258;8668
1818;3010062;Krzymów;1542;6124;898;8564
1819;3009032;Chodów;465;2368;555;3388
1820;3003023;Czerniejewo;1186;5188;689;7063
1821;3003062;Łubowo;1187;4131;566;5884
1822;3003093;Trzemeszno;2442;10482;1532;14456
1823;3009072;Koło;1645;7035;1042;9722
1824;3031053;Okonek;1553;6348;1105;9006
1825;2405052;Rudziniec;1489;7612;1653;10754
1826;2405063;Sośnicowice;1178;6165;1254;8597
1827;2406052;Opatów;1068;4799;1004;6871
1828;2411082;Rudnik;719;3620;838;5177
1829;2409023;Koziegłowy;2017;10019;2458;14494
1830;2412042;Lyski;1444;7175;1350;9969
1831;2413092;Zbrosławice;2500;13367;2860;18727
1832;2415011;Pszów;2185;10715;2193;15093
1833;2414011;Bieruń;3009;14796;1954;19759
1834;2415072;Lubomia;1207;5608;1091;7906
1835;2415082;Marklowice;762;3165;722;4649
1836;2414052;Chełm Śląski;931;4251;819;6001
1837;2417062;Lipowa;1679;6959;1153;9791
1838;2417011;Żywiec;4918;23656;4860;33434
1839;1432042;Leszno;1700;6984;1179;9863
1840;1432072;Stare Babice;3215;12475;1895;17585
1841;1433022;Grębków;729;3001;787;4517
1842;1805072;Nowy Żmigród;1495;6508;1330;9333
1843;1208012;Charsznica;1137;5113;1317;7567
1844;406033;Łasin;1414;6013;942;8369
1845;3208022;Dygowo;953;4038;590;5581
1846;3208072;Ustronie Morskie;515;2388;317;3220
1847;3209073;Sianów;2269;9930;1296;13495
1848;1205062;Łużna;1586;5775;1062;8423
1849;1205042;Gorlice;2936;11948;2424;17308
1850;2009011;Sejny;755;3567;687;5009
1851;2009032;Krasnopol;651;2703;645;3999
1852;224042;Stoszowice;840;4307;671;5818
1853;201032;Gromadka;836;4010;655;5501
1854;610022;Ludwin;916;3454;625;4995
1855;611032;Adamów;1080;4173;894;6147
1856;2203072;Rzeczenica;627;2696;392;3715
1857;1014113;Złoczew;1223;5037;1024;7284
1858;1015042;Kowiesy;436;1993;509;2938
1859;1015072;Nowy Kawęczyn;514;2318;577;3409
1860;1426122;Wodynie;741;3098;811;4650
1861;1801083;Ustrzyki Dolne;2868;13004;2077;17949
1862;2012032;Jeleniewo;596;2084;421;3101
1863;2013011;Wysokie Mazowieckie;1488;6844;1099;9431
1864;401082;Waganiec;780;3336;493;4609
1865;402042;Brzozie;711;2557;385;3653
1866;3207023;Golczewo;925;4474;670;6069
1867;611072;Stanin;1973;6670;1444;10087
1868;611092;Trzebieszów;1428;4985;1122;7535
1869;613043;Parczew;2254;10691;2030;14975
1870;2204062;Pszczółki;1554;6253;686;8493
1871;2204052;Przywidz;1129;3997;488;5614
1872;2208011;Lębork;5615;25640;4266;35521
1873;2208052;Wicko;1203;4455;521;6179
1874;1430053;Szydłowiec;3006;14027;2347;19380
1875;1803023;Brzostek;2483;9172;1739;13394
1876;1804021;Radymno;874;4363;616;5853
1877;1804112;Wiązownica;2162;8314;1369;11845
1878;1206123;Słomniki;2180;9801;1916;13897
1879;1207092;Mszana Dolna;3642;11343;2112;17097
1880;2063011;Suwałki;11252;50575;7139;68966
1881;2014011;Zambrów;3123;14883;2613;20619
1882;2062011;Łomża;9101;47436;6808;63345
1883;403072;Sicienko;3212;14682;1764;19658
1884;3015043;Nowy Tomyśl;4342;18286;2568;25196
1885;205011;Jawor;3075;17946;2853;23874
1886;1211112;Raba Wyżna;2802;9906;1633;14341
1887;202033;Pieszyce;1406;6910;1371;9687
1888;3002011;Czarnków;1375;6355;1100;8830
1889;3214011;Stargard;9630;51180;8165;68975
1890;3020013;Chocz;775;3347;538;4660
1891;2411042;Krzyżanowice;1564;8122;1719;11405
1892;210072;Siekierczyn;731;3336;518;4585
1893;211022;Lubin;2228;9963;1371;13562
1894;211043;Ścinawa;1550;7647;1203;10400
1895;415082;Wielka Nieszawka;885;3423;484;4792
1896;601072;Konstantynów;695;2807;564;4066
1897;812033;Wschowa;3564;15705;2468;21737
1898;801032;Deszczno;1510;6374;783;8667
1899;1002052;Krzyżanów;610;3107;642;4359
1900;1003023;Łask;4003;20327;3635;27965
1901;1004011;Łęczyca;2087;10337;2202;14626
1902;1416092;Szulborze Wielkie;258;1196;284;1738
1903;1435012;Brańszczyk;1305;5704;1315;8324
1904;1435032;Rząśnik;1342;4851;860;7053
1905;1435022;Długosiodło;1491;5319;1162;7972
1906;1435062;Zabrodzie;1044;3911;661;5616
1907;1437042;Lutocin;833;3006;808;4647
1908;1815033;Ropczyce;4719;19073;2954;26746
1909;1262011;Nowy Sącz;13645;60723;10913;85281
1910;214011;Oleśnica;5329;26564;5326;37219
1911;214032;Dobroszyce;1075;4666;649;6390
1912;417011;Wąbrzeźno;2210;10142;1889;14241
1913;418072;Fabianki;1634;7137;909;9680
1914;801022;Bogdaniec;1237;4878;727;6842
1915;1005062;Kocierzew Południowy;725;3002;784;4511
1916;1418063;Tarczyn;1894;7803;1453;11150
1917;1419012;Bielsk;1610;6418;1060;9088
1918;2002023;Czarna Białostocka;1808;8453;1683;11944
1919;2002042;Gródek;694;3764;1208;5666
1920;2002133;Wasilków;2729;11773;1736;16238
1921;2002103;Suraż;343;1311;382;2036
1922;2402062;Jaworze;984;4535;846;6365
1923;603022;Białopole;490;2225;445;3160
1924;603132;Wojsławice;635;2798;743;4176
1925;804043;Kożuchów;2737;11622;1996;16355
1926;1007082;Żarnów;881;4007;1103;5991
1927;1419053;Drobin;1577;5923;1125;8625
1928;1420052;Dzierzążnia;649;2767;641;4057
1929;1420072;Naruszewo;1094;4535;993;6622
1930;1818042;Radomyśl nad Sanem;1159;5019;1056;7234
1931;2003021;Brańsk;510;2219;450;3179
1932;2003042;Boćki;659;3002;1277;4938
1933;2206032;Karsin;1257;4173;725;6155
1934;2209011;Malbork;5773;28500;5021;39294
1935;1017062;Ostrówek;757;3188;709;4654
1936;1017093;Wieluń;4679;23891;4408;32978
1937;1018022;Czastary;642;2731;545;3918
1938;1402062;Ojrzeń;755;3089;542;4386
1939;1210022;Chełmiec;5228;17744;2484;25456
1940;1210062;Korzenna;3001;9396;1597;13994
1941;202052;Dzierżoniów;1308;6749;1134;9191
1942;408073;Skępe;1430;5357;970;7757
1943;408032;Chrostkowo;568;2120;384;3072
1944;3209063;Polanów;1540;6639;977;9156
1945;3210033;Dębno;3422;15195;2452;21069
1946;3211022;Kołbaskowo;2200;8238;705;11143
1947;615052;Komarówka Podlaska;698;3039;872;4609
1948;2209042;Malbork;873;3285;425;4583
1949;1020072;Parzęczew;837;3573;665;5075
1950;1020021;Ozorków;2605;14186;2744;19535
1951;1403042;Garwolin;2616;9207;1591;13414
1952;1403092;Parysów;793;2647;570;4010
1953;1808022;Grodzisko Dolne;1334;5457;1195;7986
1954;1809011;Lubaczów;1874;9401;1309;12584
1955;204022;Jemielno;536;2275;418;3229
1956;3213062;Sławno;1575;6380;813;8768
1957;3213011;Darłowo;1957;10578;1840;14375
1958;618092;Tarnawatka;739;2931;658;4328
1959;618082;Susiec;1147;5022;1230;7399
1960;618102;Telatyn;660;2961;739;4360
1961;2212053;Kępice;1545;7045;989;9579
1962;1410062;Stara Kornica;810;3314;859;4983
1963;1411011;Maków Mazowiecki;1593;7241;1182;10016
1964;1411062;Płoniawy-Bramura;918;4066;853;5837
1965;2813062;Wieliczki;627;2365;392;3384
1966;2812052;Nowe Miasto Lubawskie;1594;5664;854;8112
1967;2814033;Dobre Miasto;2561;11692;1984;16237
1968;2810032;Mrągowo;1543;6371;907;8821
1969;2810023;Mikołajki;1405;6230;1087;8722
1970;2819012;Budry;484;2111;394;2989
1971;2815083;Morąg;4223;18258;2786;25267
1972;2815052;Małdyty;1101;4650;769;6520
1973;2818022;Dubeninki;536;2171;452;3159
1974;2817022;Dźwierzuty;1242;4863;750;6855
1975;2817032;Jedwabno;698;2670;403;3771
1976;2817011;Szczytno;3196;16806;3126;23128
1977;2802072;Wilczęta;511;2203;377;3091
1978;3002083;Wieleń;2130;9085;1613;12828
1979;3002073;Trzcianka;4183;17605;2748;24536
1980;3017042;Ostrów Wielkopolski;3307;13779;2220;19306
1981;3018052;Kraszewice;683;2601;466;3750
1982;3018063;Mikstat;1020;4526;768;6314
1983;3021143;Stęszew;2464;10638;1539;14641
1984;3021011;Luboń;4955;20079;3017;28051
1985;3024083;Wronki;3006;13635;2152;18793
1986;3021033;Buk;2093;8767;1312;12172
1987;3024011;Obrzycko;381;1721;234;2336
1988;3023042;Ostrowite;891;3602;637;5130
1989;3023062;Słupca;1666;6592;1148;9406
1990;3027082;Turek;1778;6672;984;9434
1991;3023011;Słupca;1799;9583;1521;12903
1992;3027022;Brudzew;1048;4155;787;5990
1993;3026033;Książ Wielkopolski;1527;5933;808;8268
1994;3023022;Lądek;905;4050;812;5767
1995;2602023;Jędrzejów;4348;20927;4192;29467
1996;2602072;Słupia (Jędrzejowska);682;2968;769;4419
1997;2603033;Kazimierza Wielka;2162;11674;2751;16587
1998;2605072;Smyków;691;2585;502;3778
1999;2607011;Ostrowiec Świętokrzyski;9173;52596;10643;72412
2000;2606062;Sadowie;603;2898;711;4212
2001;2610032;Łączna;840;3523;679;5042
2002;2610022;Bliżyn;1118;5934;1360;8412
2003;2804093;Tolkmicko;1156;4865;807;6828
2004;2804042;Markusy;916;3005;419;4340
2005;2808062;Srokowo;625;2997;504;4126
2006;2005073;Kleszczele;287;1693;825;2805
2007;1215082;Zawoja;1656;6078;1185;8919
2008;1211082;Łapsze Niżne;1743;6785;1144;9672
2009;261011;Jelenia Góra;9834;59520;13482;82836
2010;221053;Głuszyca;1241;6790;1331;9362
2011;418052;Choceń;1286;5698;1064;8048
2012;620092;Sitno;1072;4890;915;6877
2013;1218062;Spytkowice;1729;7212;1273;10214
2014;1434093;Radzymin;4308;15893;2220;22421
2015;1411042;Krasnosielc;1203;4378;986;6567
2016;1461011;Ostrołęka;7873;38726;5487;52086
2017;1807083;Rymanów;2568;11013;2191;15772
2018;1807102;Jaśliska;452;1556;322;2330
2019;2202032;Chojnice;3645;12421;1726;17792
2020;3262011;Szczecin;51559;290592;61100;403251
2021;2210011;Krynica Morska;209;978;167;1354
2022;1006073;Koluszki;3467;16883;3299;23649
2023;207033;Lubawka;1737;8374;1452;11563
2024;2014052;Zambrów;1995;7947;1776;11718
2025;3061011;Kalisz;14905;74529;15961;105395
2026;2603043;Opatowiec;447;2410;649;3506
2027;3022042;Pakosław;914;3232;505;4651
2028;3022053;Rawicz;4938;21641;3552;30131
2029;2401042;Bobrowniki;1701;9419;2205;13325
2030;2612033;Oleśnica;612;2766;638;4016
2031;1413082;Szydłowo;821;3383;680;4884
2032;1416052;Małkinia Górna;1913;8579;1611;12103
2033;1409063;Solec nad Wisłą;688;3650;1017;5355
2034;1861011;Krosno;6780;34497;6671;47948
2035;1405032;Baranów;822;3495;668;4985
2036;1405052;Jaktorów;1862;7759;1294;10915
2037;1406032;Chynów;1594;6805;1244;9643
2038;1211123;Rabka-Zdrój;2833;12174;2591;17598
2039;206072;Mysłakowice;1588;7810;1291;10689
2040;3215023;Barwice;1522;6490;952;8964
2041;619032;Hańsk;703;2696;461;3860
2042;619042;Stary Brus;341;1475;334;2150
2043;2213112;Smętowo Graniczne;989;3923;564;5476
2044;2214011;Tczew;9762;43515;7501;60778
2045;1412042;Cegłów;909;4249;1100;6258
2046;1412052;Dębe Wielkie;1587;6086;1017;8690
2047;1412082;Jakubów;902;3489;745;5136
2048;1412112;Mińsk Mazowiecki;3211;13105;2026;18342
2049;1412132;Siennica;1197;5111;1063;7371
2050;1811032;Czermin;1283;4753;870;6906
2051;1216042;Pleśna;2201;8240;1544;11985
2052;1216032;Lisia Góra;2739;9926;1549;14214
2053;410013;Kcynia;2351;9800;1560;13711
2054;410033;Nakło nad Notecią;5477;23623;3615;32715
2055;412042;Rypin;1481;5630;1007;8118
2056;412052;Skrwilno;1134;4346;929;6409
2057;3216011;Świdwin;2445;11946;1821;16212
2058;3216022;Brzeżno;514;2169;323;3006
2059;3217011;Wałcz;3826;19567;3189;26582
2060;620032;Komarów-Osada;813;3606;1007;5426
2061;2216032;Stary Dzierzgoń;805;3091;457;4353
2062;1414052;Pomiechówek;1716;7723;1433;10872
2063;1436022;Policzna;855;4059;944;5858
2064;1409022;Ciepielów;937;3839;926;5702
2065;1812073;Ulanów;1326;5938;1173;8437
2066;1216143;Zakliczyn;2262;8446;1591;12299
2067;1216162;Szerzyny;1463;5290;1207;7960
2068;1217052;Poronin;2059;7553;1157;10769
2069;209011;Chojnów;1887;10688;1856;14431
2070;209032;Krotoszyce;577;2500;360;3437
2071;414072;Osie;1018;3906;617;5541
2072;3218023;Łobez;2213;10425;1807;14445
2073;1001011;Bełchatów;8558;47688;4283;60529
2074;1001072;Szczerców;1316;5574;1045;7935
2075;1434031;Ząbki;5060;17705;2648;25413
2076;1434052;Dąbrówka;1446;5309;883;7638
2077;1434072;Klembów;1697;6378;1093;9168
2078;1434123;Wołomin;8310;36219;6095;50624
2079;1813012;Bircza;1154;4599;933;6686
2080;1814032;Gać;800;3058;675;4533
2081;1218022;Brzeźnica;1701;6809;1285;9795
2082;605012;Batorz;572;2244;674;3490
2083;605053;Janów Lubelski;2530;11977;1949;16456
2084;605072;Potok Wielki;857;3358;778;4993
2085;805043;Rzepin;1675;7225;1067;9967
2086;1009082;Sulmierzyce;671;3138;746;4555
2087;1009022;Kiełczygłów;618;2957;786;4361
2088;1009043;Pajęczno;1792;8336;1612;11740
2089;1009032;Nowa Brzeźnica;695;3443;775;4913
2090;1420032;Baboszewo;1462;5544;1071;8077
2091;1421052;Nadarzyn;2429;8662;1202;12293
2092;1421042;Michałowice;3012;11876;2065;16953
2093;1821012;Baligród;502;2223;459;3184
2094;2004053;Szczuczyn;1066;4531;883;6480
2095;2006011;Kolno;1502;8092;1120;10714
2096;219063;Strzegom;3845;19850;3440;27135
2097;606042;Izbica;1259;5944;1639;8842
2098;606072;Łopiennik Górny;594;2714;874;4182
2099;807023;Lubniewice;420;2338;361;3119
2100;808012;Lubrza;609;2525;376;3510
2101;1609073;Niemodlin;2093;9936;1578;13607
2102;1201032;Drwinia;1299;5310;978;7587
2103;220063;Żmigród;2423;10926;1724;15073
2104;222022;Wińsko;1354;6154;1242;8750
2105;809072;Świdnica;1013;4520;640;6173
2106;1012011;Radomsko;6463;33796;7098;47357
2107;1012092;Ładzice;850;3419;700;4969
2108;1425082;Pionki;2013;8528;1785;12326
2109;1201082;Trzciana;1014;3512;642;5168
2110;1201092;Żegocina;969;3478;561;5008
2111;1203043;Libiąż;3278;16575;2769;22622
2112;2008013;Goniądz;843;3532;880;5255
2113;2008052;Krypno;678;2649;649;3976
2114;2010032;Dziadkowice;491;1955;532;2978
2115;609042;Garbów;1516;6367;1258;9141
2116;810021;Żagań;3801;19529;3258;26588
2117;2201072;Parchowo;727;2480;326;3533
2118;2201063;Miastko;3316;14574;2152;20042
2119;1013062;Sadkowice;941;3910;1021;5872
2120;1426072;Przesmyki;562;2308;735;3605
2121;3006032;Kotlin;1277;5186;804;7267
2122;3003011;Gniezno;10356;49827;8899;69082
2123;3010043;Kleczew;1629;6718;1076;9423
2124;3008052;Perzów;609;2719;469;3797
2125;3008033;Kępno;3920;17685;2929;24534
2126;3005012;Granowo;919;3536;514;4969
2127;2475011;Sosnowiec;24740;155939;31292;211971
2128;3011023;Czempiń;1946;8526;1252;11724
2129;2407062;Koszęcin;1907;8697;1606;12210
2130;2406092;Wręczyca Wielka;2722;12446;2495;17663
2131;2408021;Mikołów;5847;28125;5364;39336
2132;2405073;Toszek;1323;6678;1366;9367
2133;2412022;Gaszowice;1633;7177;1315;10125
2134;2410053;Pszczyna;8527;36362;6258;51147
2135;2410032;Miedźna;2639;12112;1051;15802
2136;2411062;Nędza;947;5297;1056;7300
2137;2413062;Ożarowice;822;4017;866;5705
2138;2415021;Radlin;2831;13621;2404;18856
2139;2416053;Łazy;2133;11970;2611;16714
2140;2417152;Węgierska Górka;2545;10490;1894;14929
2141;2416042;Kroczyce;995;4360;901;6256
2142;1432022;Izabelin;1851;7643;1330;10824
2143;1432063;Ożarów Mazowiecki;3479;16028;2967;22474
2144;1433042;Liw;1197;5195;1108;7500
2145;1805022;Brzyska;1050;4212;790;6052
2146;1805053;Kołaczyce;1666;6617;1159;9442
2147;1208072;Słaboszów;560;2432;692;3684
2148;406052;Rogóźno;803;2912;446;4161
2149;1204062;Radgoszcz;1395;5042;979;7416
2150;224053;Ząbkowice Śląskie;3072;16701;3345;23118
2151;3204062;Przybiernów;921;3868;579;5368
2152;3203033;Kalisz Pomorski;1275;5289;768;7332
2153;610052;Puchaczów;937;3458;679;5074
2154;611082;Stoczek Łukowski;1356;5366;1489;8211
2155;2203052;Koczała;559;2571;395;3525
2156;1427052;Sierpc;1238;4779;926;6943
2157;1427042;Rościszewo;710;2882;649;4241
2158;1429062;Repki;843;3745;1092;5680
2159;1429042;Jabłonna Lacka;688;3302;994;4984
2160;1601011;Brzeg;5226;26918;5479;37623
2161;1206012;Czernichów;2191;9490;1655;13336
2162;1206052;Kocmyrzów-Luborzyca;2444;10491;1793;14728
2163;1206092;Mogilany;2279;8819;1352;12450
2164;2012012;Bakałarzewo;503;2101;451;3055
2165;2012042;Przerośl;540;2080;490;3110
2166;2012092;Wiżajny;421;1678;378;2477
2167;2013082;Sokoły;898;4085;990;5973
2168;401062;Koneck;589;2330;500;3419
2169;402092;Świedziebnia;953;3605;658;5216
2170;402082;Osiek;751;2779;558;4088
2171;612063;Poniatowa;2192;10716;1985;14893
2172;612042;Łaziska;862;3623;914;5399
2173;612032;Karczmiska;886;4189;991;6066
2174;612053;Opole Lubelskie;2769;12436;2505;17710
2175;2205052;Somonino;2173;6517;824;9514
2176;2205032;Przodkowo;1808;5339;687;7834
2177;1017012;Biała;900;3739;776;5415
2178;1430022;Jastrząb;885;3384;653;4922
2179;1803072;Żyraków;2452;9365;1635;13452
2180;1206143;Świątniki Górne;1566;6415;945;8926
2181;1207072;Limanowa;5164;16533;2597;24294
2182;2013102;Wysokie Mazowieckie;940;3635;914;5489
2183;403032;Dobrcz;1887;7265;1051;10203
2184;405011;Golub-Dobrzyń;2006;9065;1329;12400
2185;3206012;Banie;1146;4794;689;6629
2186;1604013;Byczyna;1528;6854;1204;9586
2187;3005043;Rakoniewice;2560;9263;1194;13017
2188;1604043;Wołczyn;2118;10297;1887;14302
2189;2202011;Chojnice;6524;29006;4683;40213
2190;203022;Głogów;2367;11453;1177;14997
2191;2808022;Barciany;1101;4809;851;6761
2192;2417142;Ujsoły;738;3268;797;4803
2193;211011;Lubin;10447;55845;9043;75335
2194;212053;Wleń;561;3296;548;4405
2195;414093;Świecie;5398;24994;3812;34204
2196;415022;Chełmża;1715;6722;1087;9524
2197;601092;Łomazy;879;3409;928;5216
2198;1002072;Łanięta;435;1755;363;2553
2199;1002102;Strzelce;600;2801;600;4001
2200;1003042;Widawa;1040;5106;1418;7564
2201;1003032;Sędziejowice;957;4354;952;6263
2202;1003052;Wodzierady;470;2232;495;3197
2203;1004042;Grabów;898;4436;1083;6417
2204;1416062;Nur;399;1796;667;2862
2205;1417043;Karczew;1868;8832;1623;12323
2206;1437063;Żuromin;2338;10599;1850;14787
2207;1816011;Dynów;923;4158;782;5863
2208;1816023;Błażowa;1716;7338;1719;10773
2209;1219032;Kłaj;1813;7642;1268;10723
2210;2001022;Augustów;1256;4598;929;6783
2211;417032;Książki;734;3081;507;4322
2212;417042;Płużnica;857;3535;571;4963
2213;418043;Brześć Kujawski;1825;8357;1503;11685
2214;602112;Potok Górny;819;3845;912;5576
2215;802042;Dąbie;832;3665;472;4969
2216;802063;Krosno Odrzańskie;2729;13569;1995;18293
2217;1438011;Żyrardów;6067;28537;5614;40218
2218;1463011;Radom;32262;159128;30955;222345
2219;1816082;Kamień;1204;4465;876;6545
2220;214083;Twardogóra;2009;9568;1357;12934
2221;2207043;Prabuty;2425;9602;1437;13464
2222;215022;Domaniów;945;3781;612;5338
2223;215011;Oława;4662;22913;4443;32018
2224;418083;Izbica Kujawska;1373;5536;1060;7969
2225;2468011;Jaworzno;12577;68673;13372;94622
2226;603062;Kamień;711;2967;508;4186
2227;603082;Rejowiec Fabryczny;679;3091;741;4511
2228;604032;Horodło;782;3714;969;5465
2229;803063;Trzciel;1055;4741;761;6557
2230;804032;Kolsko;553;2299;346;3198
2231;804052;Nowa Sól;1307;5829;797;7933
2232;1007062;Poświętne;526;2153;618;3297
2233;1419112;Słubice;767;3116;661;4544
2234;1603022;Bierawa;990;5464;1239;7693
2235;1605023;Krapkowice;3128;17302;3331;23761
2236;1606012;Domaszowice;614;2646;447;3707
2237;1817073;Zagórz;2182;9576;1599;13357
2238;1818032;Pysznica;1631;7476;1296;10403
2239;2003052;Brańsk;1012;4111;1403;6526
2240;2003082;Wyszki;745;2945;1112;4802
2241;2004062;Wąsosz;742;2603;637;3982
2242;216032;Grębocice;936;3823;617;5376
2243;216022;Gaworzyce;694;2812;428;3934
2244;404022;Chełmno;1074;3878;558;5510
2245;2402072;Kozy;1927;8589;1624;12140
2246;2401052;Mierzęcice;975;5072;1056;7103
2247;3210013;Barlinek;3054;14581;2141;19776
2248;615062;Radzyń Podlaski;1542;5789;1136;8467
2249;2210023;Nowy Dwór Gdański;3054;13044;1923;18021
2250;2211031;Puck;1377;5915;1004;8296
2251;2211072;Puck;5554;18611;2619;26784
2252;1020083;Stryków;1852;8837;1688;12377
2253;1403021;Łaskarzew;830;3696;520;5046
2254;1403052;Górzno;1141;4268;808;6217
2255;1403132;Wilga;876;3626;838;5340
2256;1808011;Leżajsk;2136;10771;1684;14591
2257;203032;Jerzmanowa;884;2950;352;4186
2258;204013;Góra;3464;15099;2466;21029
2259;3212012;Bielice;606;2292;331;3229
2260;3212062;Warnice;562;2601;415;3578
2261;3213052;Postomino;1312;5068;665;7045
2262;2212022;Damnica;1141;4578;588;6307
2263;2212082;Słupsk;2867;11794;1284;15945
2264;2213021;Skórcz;690;2608;327;3625
2265;2213102;Skórcz;903;3317;467;4687
2266;2811043;Nidzica;3454;15855;2399;21708
2267;2814082;Kolno;508;2261;425;3194
2268;2811012;Janowiec Kościelny;591;2242;468;3301
2269;2817052;Rozogi;1115;4089;615;5819
2270;2816023;Orzysz;1846;7438;1256;10540
2271;2815073;Miłomłyn;838;3643;620;5101
2272;2817072;Świętajno;1060;4373;707;6140
2273;2814122;Świątki;777;2963;451;4191
2274;3002052;Lubasz;1494;6078;832;8404
2275;3017072;Sieroszewice;1601;6767;1114;9482
2276;3018033;Grabów nad Prosną;1369;5515;1013;7897
2277;3024063;Pniewy;2209;9193;1244;12646
2278;3021113;Murowana Goślina;2684;12514;1237;16435
2279;3021042;Czerwonak;4354;19108;1932;25394
2280;3021072;Komorniki;4158;14146;1554;19858
2281;3021093;Kórnik;4126;14993;1935;21054
2282;3022013;Bojanowo;1544;6313;1026;8883
2283;3027052;Malanów;1193;4426;744;6363
2284;3027033;Dobra;1078;4559;1009;6646
2285;3027092;Władysławów;1511;5732;871;8114
2286;2603022;Czarnocin;508;2636;725;3869
2287;2604142;Piekoszów;2770;11257;1720;15747
2288;2612053;Połaniec;1866;9066;1061;11993
2289;2609043;Koprzywnica;1046;4851;1110;7007
2290;2609022;Dwikozy;1256;6305;1400;8961
2291;2609093;Zawichost;649;3191;783;4623
2292;2804012;Elbląg;1319;5311;622;7252
2293;2613063;Włoszczowa;3008;14533;2797;20338
2294;2809011;Lidzbark Warmiński;2145;10642;2078;14865
2295;2807043;Kisielice;1117;4486;624;6227
2296;2011062;Nowy Dwór;393;1825;605;2823
2297;1610043;Prudnik;3788;18810;4161;26759
2298;1610032;Lubrza;845;4657;733;6235
2299;1607063;Otmuchów;2205;10666;1941;14812
2300;1607013;Głuchołazy;3381;18128;3701;25210
2301;1217032;Bukowina Tatrzańska;2207;8363;1494;12064
2302;1210113;Muszyna;2139;8012;1289;11440
2303;605063;Modliborzyce;1152;4871;1170;7193
2304;603153;Rejowiec;1004;4654;1027;6685
2305;225052;Sulików;1137;5112;737;6986
2306;210062;Platerówka;277;1246;191;1714
2307;208031;Kudowa-Zdrój;1310;6926;1452;9688
2308;2605043;Radoszyce;1489;6533;1362;9384
2309;3007083;Opatówek;1720;7541;1432;10693
2310;1408032;Nieporęt;2787;10002;1283;14072
2311;2479011;Żory;9848;46878;5262;61988
2312;2818033;Gołdap;3559;14580;2109;20248
2313;3204023;Goleniów;5689;25547;3768;35004
2314;2208021;Łeba;465;2598;486;3549
2315;1006022;Andrespol;1899;8731;1601;12231
2316;3203023;Drawsko Pomorskie;2736;13033;2069;17838
2317;206021;Kowary;1612;8595;1608;11815
2318;1008062;Lutomiersk;1248;5590;1165;8003
2319;1007032;Mniszków;792;3227;751;4770
2320;2007043;Nowogród;717;2852;558;4127
2321;1416082;Stary Lubotyń;680;2528;644;3852
2322;3017023;Nowe Skalmierzyce;2577;11321;1827;15725
2323;2202043;Czersk;4006;15120;2485;21611
2324;2815092;Ostróda;2836;11352;1606;15794
2325;2612022;Łubnice;664;2803;793;4260
2326;1407062;Magnuszew;1164;4730;921;6815
2327;3207043;Międzyzdroje;938;5244;871;7053
2328;2609033;Klimontów;1466;5956;1342;8764
2329;1420113;Sochocin;959;4234;828;6021
2330;1863011;Rzeszów;25694;132639;23844;182177
2331;2604172;Nowiny;1295;5642;915;7852
2332;1404052;Szczawin Kościelny;770;3583;750;5103
2333;1211092;Nowy Targ;4482;16042;2591;23115
2334;1212032;Bolesław;1221;6038;1380;8639
2335;1215052;Jordanów;2049;7155;1237;10441
2336;207042;Marciszów;732;3391;570;4693
2337;409012;Dąbrowa;841;3425;532;4798
2338;411062;Radziejów;718;3209;643;4570
2339;3214042;Dolice;1462;5883;892;8237
2340;3215011;Szczecinek;5725;29763;5185;40673
2341;3215033;Biały Bór;824;3928;615;5367
2342;619072;Wola Uhruska;578;2926;642;4146
2343;2214023;Gniew;2703;11128;1821;15652
2344;2214032;Morzeszczyn;771;2768;317;3856
2345;1406062;Jasieniec;913;3724;783;5420
2346;1406073;Mogielnica;1346;6282;1516;9144
2347;1407053;Kozienice;4427;22828;3522;30777
2348;1811052;Mielec;1950;7643;1455;11048
2349;1811022;Borowa;1023;4021;799;5843
2350;1811062;Padew Narodowa;866;3687;758;5311
2351;1213062;Oświęcim;3246;14791;2807;20844
2352;1216053;Radłów;1601;7159;1484;10244
2353;208041;Nowa Ruda;2948;16963;3940;23851
2354;412011;Rypin;2496;11752;1886;16134
2355;620043;Krasnobród;1213;4832;1134;7179
2356;620022;Grabowiec;646;2932;923;4501
2357;2215072;Luzino;3381;9798;1012;14191
2358;1413022;Dzierzgowo;547;2255;555;3357
2359;1414011;Nowy Dwór Mazowiecki;4055;19122;3107;26284
2360;1414022;Czosnów;1600;6682;1157;9439
2361;1436042;Tczów;897;3336;609;4842
2362;1408022;Jabłonna;4131;14654;1625;20410
2363;1216092;Tarnów;4277;17577;2965;24819
2364;209073;Prochowice;1223;5559;801;7583
2365;413032;Sośno;918;3627;575;5120
2366;413023;Sępólno Krajeńskie;2742;11342;1928;16012
2367;414042;Jeżewo;1386;5582;836;7804
2368;3261011;Koszalin;13886;79597;15914;109397
2369;811043;Jasień;1132;5310;869;7311
2370;1434082;Poświętne;1087;4228;696;6011
2371;1813042;Krasiczyn;888;3491;553;4932
2372;1814011;Przeworsk;2473;11666;2017;16156
2373;1218072;Stryszów;1234;4953;910;7097
2374;2401073;Siewierz;1631;8523;1748;11902
2375;805022;Górzyca;790;3020;452;4262
2376;1008011;Konstantynów Łódzki;2265;12682;2594;17541
2377;1420011;Płońsk;3357;16363;2571;22291
2378;1820013;Baranów Sandomierski;1982;8449;1706;12137
2379;1820032;Grębów;1568;6211;1284;9063
2380;1821042;Olszanica;804;3629;679;5112
2381;2403052;Chybie;1609;6600;1077;9286
2382;607032;Dzierzkowice;878;3820;877;5575
2383;607072;Trzydnik Duży;1092;4779;1193;7064
2384;1010072;Ręczno;537;2386;573;3496
2385;1422032;Czernice Borowe;604;2730;603;3937
2386;1422062;Krzynowłoga Mała;660;2485;502;3647
2387;1608023;Gorzów Śląski;1080;5567;1147;7794
2388;221082;Walim;834;4344;820;5998
2389;221072;Stare Bogaczowice;628;3148;500;4276
2390;2404102;Mstów;1682;7643;1342;10667
2391;2404082;Kruszyna;747;3477;677;4901
2392;2404072;Konopiska;1488;7488;1506;10482
2393;2404132;Poczesna;1867;9509;1829;13205
2394;608072;Lubartów;2400;9458;1491;13349
2395;809082;Trzebiechów;577;2373;392;3342
2396;810092;Żagań;1254;5235;726;7215
2397;1012032;Gidle;897;4501;1081;6479
2398;1425011;Pionki;2288;13270;2174;17732
2399;2008072;Trzcianne;709;3044;859;4612
2400;223012;Czernica;2193;8111;1051;11355
2401;223043;Kąty Wrocławskie;3743;15215;2265;21223
2402;223083;Siechnice;2744;12189;1711;16644
2403;223092;Żórawina;1505;6869;953;9327
2404;224022;Ciepłowody;484;2373;410;3267
2405;3201022;Białogard;1465;6279;878;8622
2406;3201043;Tychowo;1135;4742;697;6574
2407;609092;Krzczonów;662;3030;992;4684
2408;609162;Zakrzew;447;1998;695;3140
2409;810032;Brzeźnica;687;2817;409;3913
2410;1014062;Goszczanów;983;3792;925;5700
2411;1426042;Mokobody;906;3549;838;5293
2412;3004023;Gostyń;4245;19837;3283;27365
2413;3007012;Blizanów;1607;6872;1176;9655
2414;3007112;Żelazków;1501;6505;1115;9121
2415;3008022;Bralin;1099;4232;678;6009
2416;3012043;Krotoszyn;6598;29091;4921;40610
2417;2406032;Lipie;946;4516;959;6421
2418;2407083;Woźniki;1520;6915;1331;9766
2419;2405011;Knurów;5334;24862;4540;34736
2420;2408052;Wyry;1296;5205;916;7417
2421;2410062;Suszec;2139;8151;1114;11404
2422;2409011;Myszków;4367;23563;4521;32451
2423;2409042;Poraj;1470;7498;1740;10708
2424;2413052;Krupski Młyn;442;2019;466;2927
2425;2409032;Niegowa;895;3920;789;5604
2426;1433011;Węgrów;1964;9483;1459;12906
2427;1806023;Kolbuszowa;4077;17909;3185;25171
2428;1806042;Niwiska;1161;4150;793;6104
2429;1805011;Jasło;5025;25598;4949;35572
2430;1805032;Dębowiec;1480;6036;1182;8698
2431;1208053;Miechów;2841;13986;3136;19963
2432;1209022;Lubień;1944;6554;1096;9594
2433;1209033;Myślenice;7572;29950;5095;42617
2434;405062;Zbójno;783;2999;644;4426
2435;407011;Inowrocław;9693;53705;9463;72861
2436;3206092;Widuchowa;890;3768;584;5242
2437;3209033;Bobolice;1594;7120;1080;9794
2438;613052;Podedwórze;246;1189;367;1802
2439;1601052;Lubsza;1381;6494;1134;9009
2440;1601062;Olszanka;810;3533;665;5008
2441;1204052;Olesno;1261;5593;998;7852
2442;224063;Ziębice;2597;13337;2706;18640
2443;401011;Aleksandrów Kujawski;1027;4655;872;6554
2444;3204033;Maszewo;1614;6148;856;8618
2445;609152;Wysokie;703;3006;1055;4764
2446;610033;Łęczna;3716;19554;1527;24797
2447;2203011;Człuchów;2122;10907;1651;14680
2448;1427032;Mochowo;1162;4251;790;6203
2449;1802022;Domaradz;1133;4327;947;6407
2450;1802042;Haczów;1675;6524;1244;9443
2451;1803032;Czarna;2235;8945;1612;12792
2452;1206172;Zielonki;3131;12315;2003;17449
2453;2012022;Filipów;829;3191;658;4678
2454;3205012;Brojce;712;2782;368;3862
2455;613022;Jabłoń;621;2792;674;4087
2456;2204032;Kolbudy;2739;9737;984;13460
2457;2204072;Suchy Dąb;737;2933;352;4022
2458;1017052;Osjaków;808;3241;744;4793
2459;1017042;Mokrsko;936;3692;780;5408
2460;1428052;Nowa Sucha;1095;4470;806;6371
2461;1428022;Brochów;695;3014;630;4339
2462;1804011;Jarosław;5507;28754;5343;39604
2463;1804062;Pawłosiów;1351;5865;1027;8243
2464;1207062;Laskowa;1809;5257;914;7980
2465;2013033;Czyżew;1122;4477;963;6562
2466;2013093;Szepietowo;1285;5064;1326;7675
2467;403052;Nowa Wieś Wielka;1734;6907;794;9435
2468;405032;Golub-Dobrzyń;1537;6182;1033;8752
2469;3005053;Wielichowo;1253;4835;653;6741
2470;1604023;Kluczbork;4819;27023;5243;37085
2471;2807073;Zalewo;1208;5024;865;7097
2472;1002092;Oporów;409;1946;435;2790
2473;203052;Pęcław;449;1667;237;2353
2474;205042;Mściwojów;668;2943;576;4187
2475;2806102;Wydminy;1112;4621;883;6616
2476;603113;Siedliszcze;1145;4788;1053;6986
2477;2417042;Jeleśnia;2251;9633;1939;13823
